org_name,Year,Month,Recetpts,Disposals,Pending,Response_rate,,,
Central Board of Direct Taxes (Income Tax),2016,1,1600,49,1551,0.030625,,,
Central Board of Direct Taxes (Income Tax),2016,2,2106,207,1899,0.098290598,,,
Central Board of Direct Taxes (Income Tax),2016,3,2465,2702,-237,1.096146045,,,
Central Board of Direct Taxes (Income Tax),2016,4,1912,1320,592,0.690376569,,,
Central Board of Direct Taxes (Income Tax),2016,5,2797,1588,1209,0.567751162,,,
Central Board of Direct Taxes (Income Tax),2016,6,2813,2944,-131,1.046569499,,,
Central Board of Direct Taxes (Income Tax),2016,7,2358,2893,-535,1.226887193,,,
Central Board of Direct Taxes (Income Tax),2016,8,2676,3929,-1253,1.468236173,,,
Central Board of Direct Taxes (Income Tax),2016,9,2258,2043,215,0.904782994,,,
Central Board of Direct Taxes (Income Tax),2016,10,1924,2942,-1018,1.529106029,,,
Central Board of Direct Taxes (Income Tax),2016,11,3452,2527,925,0.732039397,,,
Central Board of Direct Taxes (Income Tax),2016,12,5707,5851,-144,1.025232171,,,
Central Board of Direct Taxes (Income Tax),2017,1,4038,4592,-554,1.137196632,,,
Central Board of Direct Taxes (Income Tax),2017,2,3939,3520,419,0.893627824,,,
Central Board of Direct Taxes (Income Tax),2017,3,4403,3872,531,0.879400409,,,
Central Board of Direct Taxes (Income Tax),2017,4,3638,3849,-211,1.0579989,,,
Central Board of Direct Taxes (Income Tax),2017,5,4409,3890,519,0.882286233,,,
Central Board of Direct Taxes (Income Tax),2017,6,3634,3924,-290,1.079801871,,,
Central Board of Direct Taxes (Income Tax),2017,7,3963,3618,345,0.912944739,,,
Central Board of Direct Taxes (Income Tax),2017,8,3273,4646,-1373,1.41949282,,,
Central Board of Direct Taxes (Income Tax),2017,9,3204,3825,-621,1.193820225,,,
Central Board of Direct Taxes (Income Tax),2017,10,3380,3332,48,0.985798817,,,
Central Board of Direct Taxes (Income Tax),2017,11,3107,3491,-384,1.123591889,,,
Central Board of Direct Taxes (Income Tax),2017,12,2966,2502,464,0.843560351,,,
Central Board of Direct Taxes (Income Tax),2018,1,2622,2684,-62,1.023646072,,,
Central Board of Direct Taxes (Income Tax),2018,2,2427,2658,-231,1.095179234,,,
Central Board of Direct Taxes (Income Tax),2018,3,2932,2811,121,0.958731241,,,
Central Board of Direct Taxes (Income Tax),2018,4,2796,2358,438,0.843347639,,,
Central Board of Direct Taxes (Income Tax),2018,5,2969,3015,-46,1.015493432,,,
Central Board of Direct Taxes (Income Tax),2018,6,2610,2703,-93,1.035632184,,,
Central Board of Direct Taxes (Income Tax),2018,7,2975,2914,61,0.979495798,,,
Central Board of Direct Taxes (Income Tax),2018,8,3051,3151,-100,1.032776139,,,
Central Board of Direct Taxes (Income Tax),2018,9,2160,2249,-89,1.041203704,,,
Central Board of Direct Taxes (Income Tax),2018,10,2592,2770,-178,1.06867284,,,
Central Board of Direct Taxes (Income Tax),2018,11,2674,2355,319,0.880703067,,,
Central Board of Direct Taxes (Income Tax),2018,12,2316,2158,158,0.931778929,,,
Central Board of Direct Taxes (Income Tax),2019,1,2974,2929,45,0.984868863,,,
Central Board of Direct Taxes (Income Tax),2019,2,3212,2853,359,0.888231631,,,
Central Board of Direct Taxes (Income Tax),2019,3,3262,3345,-83,1.025444513,,,
Central Board of Direct Taxes (Income Tax),2019,4,2885,2437,448,0.844714038,,,
Central Board of Direct Taxes (Income Tax),2019,5,3188,3847,-659,1.206712673,102607,,
Central Board of Direct Taxes (Income Tax),2019,6,3059,3027,32,0.989539065,,,
Central Board of Direct Taxes (Income Tax),2019,7,3534,3426,108,0.969439728,,,
Central Board of Direct Taxes (Income Tax),2019,8,3815,3562,253,0.933682831,,,
Central Board of Direct Taxes (Income Tax),2019,9,3761,3735,26,0.993086945,,,
Central Board of Direct Taxes (Income Tax),2019,10,2700,2804,-104,1.038518519,,,
Central Board of Direct Taxes (Income Tax),2019,11,100,190,-90,1.9,,,
Central Board of Indirect Taxes and Customs,2016,1,474,181,293,0.38185654,,,
Central Board of Indirect Taxes and Customs,2016,2,687,413,274,0.601164483,,,
Central Board of Indirect Taxes and Customs,2016,3,1107,1333,-226,1.204155375,,,
Central Board of Indirect Taxes and Customs,2016,4,904,818,86,0.904867257,,,
Central Board of Indirect Taxes and Customs,2016,5,990,960,30,0.96969697,,,
Central Board of Indirect Taxes and Customs,2016,6,1017,918,99,0.902654867,,,
Central Board of Indirect Taxes and Customs,2016,7,724,798,-74,1.102209945,,,
Central Board of Indirect Taxes and Customs,2016,8,679,754,-75,1.110456554,,,
Central Board of Indirect Taxes and Customs,2016,9,711,647,64,0.909985935,,,
Central Board of Indirect Taxes and Customs,2016,10,656,697,-41,1.0625,,,
Central Board of Indirect Taxes and Customs,2016,11,761,742,19,0.975032852,,,
Central Board of Indirect Taxes and Customs,2016,12,816,795,21,0.974264706,,,
Central Board of Indirect Taxes and Customs,2017,1,835,901,-66,1.079041916,,,
Central Board of Indirect Taxes and Customs,2017,2,858,864,-6,1.006993007,,,
Central Board of Indirect Taxes and Customs,2017,3,972,918,54,0.944444444,,,
Central Board of Indirect Taxes and Customs,2017,4,980,877,103,0.894897959,,,
Central Board of Indirect Taxes and Customs,2017,5,2365,2176,189,0.920084567,,,
Central Board of Indirect Taxes and Customs,2017,6,3348,2572,776,0.768219833,,,
Central Board of Indirect Taxes and Customs,2017,7,3671,3963,-292,1.079542359,,,
Central Board of Indirect Taxes and Customs,2017,8,2567,2430,137,0.946630308,,119024,
Central Board of Indirect Taxes and Customs,2017,9,2579,2648,-69,1.026754556,,,
Central Board of Indirect Taxes and Customs,2017,10,3709,2315,1394,0.624157455,,,
Central Board of Indirect Taxes and Customs,2017,11,3092,3108,-16,1.005174644,,,
Central Board of Indirect Taxes and Customs,2017,12,1492,2796,-1304,1.873994638,,,
Central Board of Indirect Taxes and Customs,2018,1,1422,1893,-471,1.331223629,,,
Central Board of Indirect Taxes and Customs,2018,2,1254,1393,-139,1.110845295,,,
Central Board of Indirect Taxes and Customs,2018,3,1438,1214,224,0.844228095,,,
Central Board of Indirect Taxes and Customs,2018,4,1485,1459,26,0.982491582,,,
Central Board of Indirect Taxes and Customs,2018,5,1361,1564,-203,1.149155033,,,
Central Board of Indirect Taxes and Customs,2018,6,1263,1183,80,0.936658749,,,
Central Board of Indirect Taxes and Customs,2018,7,1483,1402,81,0.945380984,,,
Central Board of Indirect Taxes and Customs,2018,8,1253,1315,-62,1.049481245,,,
Central Board of Indirect Taxes and Customs,2018,9,638,893,-255,1.39968652,,,
Central Board of Indirect Taxes and Customs,2018,10,1160,1102,58,0.95,,,
Central Board of Indirect Taxes and Customs,2018,11,925,861,64,0.930810811,,,
Central Board of Indirect Taxes and Customs,2018,12,775,820,-45,1.058064516,,,
Central Board of Indirect Taxes and Customs,2019,1,2035,1423,612,0.699262899,,,
Central Board of Indirect Taxes and Customs,2019,2,1451,1968,-517,1.356305996,,,
Central Board of Indirect Taxes and Customs,2019,3,1063,1037,26,0.975540922,,,
Central Board of Indirect Taxes and Customs,2019,4,936,937,-1,1.001068376,,,
Central Board of Indirect Taxes and Customs,2019,5,1567,1390,177,0.88704531,89611,,
Central Board of Indirect Taxes and Customs,2019,6,1050,1107,-57,1.054285714,,,
Central Board of Indirect Taxes and Customs,2019,7,1297,1416,-119,1.091750193,,,
Central Board of Indirect Taxes and Customs,2019,8,1429,1161,268,0.812456263,,,
Central Board of Indirect Taxes and Customs,2019,9,2119,1876,243,0.885323266,,,
Central Board of Indirect Taxes and Customs,2019,10,1151,1613,-462,1.401390096,,,
Central Board of Indirect Taxes and Customs,2019,11,51,44,7,0.862745098,,,
Committee on Petitions Rajya Sabha,2018,7,3,1,2,0.333333333,,,
Committee on Petitions Rajya Sabha,2018,10,3,1,2,0.333333333,,,
Committee on Petitions Rajya Sabha,2018,11,2,1,1,0.5,,,
Committee on Petitions Rajya Sabha,2018,12,5,3,2,0.6,,,
Committee on Petitions Rajya Sabha,2019,1,4,2,2,0.5,,,
Committee on Petitions Rajya Sabha,2019,2,1,1,0,1,,,
Committee on Petitions Rajya Sabha,2019,9,1,2,-1,2,,,
Department of Administrative Reforms and PG,2016,1,37,7,30,0.189189189,,,
Department of Administrative Reforms and PG,2016,2,61,72,-11,1.180327869,,,
Department of Administrative Reforms and PG,2016,3,30,31,-1,1.033333333,,,
Department of Administrative Reforms and PG,2016,4,28,37,-9,1.321428571,,,
Department of Administrative Reforms and PG,2016,5,27,22,5,0.814814815,,,
Department of Administrative Reforms and PG,2016,6,42,34,8,0.80952381,,,
Department of Administrative Reforms and PG,2016,7,24,1,23,0.041666667,,,
Department of Administrative Reforms and PG,2016,8,45,46,-1,1.022222222,,,
Department of Administrative Reforms and PG,2016,9,36,46,-10,1.277777778,,,
Department of Administrative Reforms and PG,2016,10,32,36,-4,1.125,,,
Department of Administrative Reforms and PG,2016,11,35,1,34,0.028571429,,,
Department of Administrative Reforms and PG,2016,12,45,63,-18,1.4,,,
Department of Administrative Reforms and PG,2017,1,28,28,0,1,,,
Department of Administrative Reforms and PG,2017,2,22,43,-21,1.954545455,,,
Department of Administrative Reforms and PG,2017,3,35,33,2,0.942857143,,,
Department of Administrative Reforms and PG,2017,4,28,17,11,0.607142857,,,
Department of Administrative Reforms and PG,2017,5,22,36,-14,1.636363636,,,
Department of Administrative Reforms and PG,2017,6,21,23,-2,1.095238095,,,
Department of Administrative Reforms and PG,2017,7,24,3,21,0.125,,,
Department of Administrative Reforms and PG,2017,8,27,56,-29,2.074074074,,0.82248118,
Department of Administrative Reforms and PG,2017,9,18,1,17,0.055555556,,,
Department of Administrative Reforms and PG,2017,10,17,32,-15,1.882352941,,,
Department of Administrative Reforms and PG,2017,11,32,33,-1,1.03125,,,
Department of Administrative Reforms and PG,2018,1,36,51,-15,1.416666667,,,
Department of Administrative Reforms and PG,2018,2,20,2,18,0.1,,,
Department of Administrative Reforms and PG,2018,3,31,5,26,0.161290323,,,
Department of Administrative Reforms and PG,2018,4,38,40,-2,1.052631579,,,
Department of Administrative Reforms and PG,2018,5,35,86,-51,2.457142857,,,
Department of Administrative Reforms and PG,2018,6,29,15,14,0.517241379,,,
Department of Administrative Reforms and PG,2018,7,48,46,2,0.958333333,,,
Department of Administrative Reforms and PG,2018,8,55,53,2,0.963636364,,,
Department of Administrative Reforms and PG,2018,9,50,49,1,0.98,,,
Department of Administrative Reforms and PG,2018,10,29,33,-4,1.137931034,,,
Department of Administrative Reforms and PG,2018,11,22,5,17,0.227272727,,,
Department of Administrative Reforms and PG,2018,12,24,58,-34,2.416666667,,,
Department of Administrative Reforms and PG,2019,1,25,9,16,0.36,,,
Department of Administrative Reforms and PG,2019,2,22,35,-13,1.590909091,,,
Department of Administrative Reforms and PG,2019,3,31,32,-1,1.032258065,,,
Department of Administrative Reforms and PG,2019,4,28,18,10,0.642857143,,,
Department of Administrative Reforms and PG,2019,6,32,63,-31,1.96875,,,
Department of Administrative Reforms and PG,2019,7,61,57,4,0.93442623,,,
Department of Administrative Reforms and PG,2019,8,32,36,-4,1.125,,,
Department of Administrative Reforms and PG,2019,9,45,17,28,0.377777778,,,
Department of Administrative Reforms and PG,2019,10,53,58,-5,1.094339623,,,
Department of Agriculture Research and Education,2016,1,82,1,81,0.012195122,,,
Department of Agriculture Research and Education,2016,2,127,24,103,0.188976378,,,
Department of Agriculture Research and Education,2016,3,144,186,-42,1.291666667,,,
Department of Agriculture Research and Education,2016,4,165,144,21,0.872727273,,,
Department of Agriculture Research and Education,2016,5,122,128,-6,1.049180328,,,
Department of Agriculture Research and Education,2016,6,148,57,91,0.385135135,,,
Department of Agriculture Research and Education,2016,7,129,125,4,0.968992248,,,
Department of Agriculture Research and Education,2016,8,130,62,68,0.476923077,,,
Department of Agriculture Research and Education,2016,9,104,37,67,0.355769231,,,
Department of Agriculture Research and Education,2016,10,118,89,29,0.754237288,,,
Department of Agriculture Research and Education,2016,11,101,25,76,0.247524752,,,
Department of Agriculture Research and Education,2016,12,107,64,43,0.598130841,,,
Department of Agriculture Research and Education,2017,1,87,367,-280,4.218390805,,,
Department of Agriculture Research and Education,2017,2,116,132,-16,1.137931034,,,
Department of Agriculture Research and Education,2017,3,194,190,4,0.979381443,,,
Department of Agriculture Research and Education,2017,4,158,142,16,0.898734177,,,
Department of Agriculture Research and Education,2017,5,192,174,18,0.90625,,,
Department of Agriculture Research and Education,2017,6,173,213,-40,1.231213873,,,
Department of Agriculture Research and Education,2017,7,210,130,80,0.619047619,,,
Department of Agriculture Research and Education,2017,8,180,157,23,0.872222222,,,
Department of Agriculture Research and Education,2017,9,152,141,11,0.927631579,,,
Department of Agriculture Research and Education,2017,10,126,134,-8,1.063492063,,,
Department of Agriculture Research and Education,2017,11,155,372,-217,2.4,,,
Department of Agriculture Research and Education,2017,12,104,160,-56,1.538461538,,,
Department of Agriculture Research and Education,2018,1,121,130,-9,1.074380165,,,
Department of Agriculture Research and Education,2018,2,126,117,9,0.928571429,,,
Department of Agriculture Research and Education,2018,3,99,111,-12,1.121212121,,,
Department of Agriculture Research and Education,2018,4,111,123,-12,1.108108108,,,
Department of Agriculture Research and Education,2018,5,168,168,0,1,,,
Department of Agriculture Research and Education,2018,6,132,105,27,0.795454545,,,
Department of Agriculture Research and Education,2018,7,153,139,14,0.908496732,,,
Department of Agriculture Research and Education,2018,8,170,120,50,0.705882353,,,
Department of Agriculture Research and Education,2018,9,153,132,21,0.862745098,,,
Department of Agriculture Research and Education,2018,10,154,191,-37,1.24025974,,,
Department of Agriculture Research and Education,2018,11,116,150,-34,1.293103448,,,
Department of Agriculture Research and Education,2018,12,111,110,1,0.990990991,,,
Department of Agriculture Research and Education,2019,1,132,159,-27,1.204545455,,,
Department of Agriculture Research and Education,2019,2,189,129,60,0.682539683,,,
Department of Agriculture Research and Education,2019,3,168,174,-6,1.035714286,,,
Department of Agriculture Research and Education,2019,4,125,109,16,0.872,,,
Department of Agriculture Research and Education,2019,5,95,123,-28,1.294736842,1.145026838,,
Department of Agriculture Research and Education,2019,6,145,97,48,0.668965517,,,
Department of Agriculture Research and Education,2019,7,194,137,57,0.706185567,,,
Department of Agriculture Research and Education,2019,8,169,157,12,0.928994083,,,
Department of Agriculture Research and Education,2019,9,150,157,-7,1.046666667,,,
Department of Agriculture Research and Education,2019,10,191,125,66,0.654450262,,,
"Department of Agriculture, Cooperation and Farmers Welfare",2016,1,435,91,344,0.209195402,,,
"Department of Agriculture, Cooperation and Farmers Welfare",2016,2,481,375,106,0.77962578,,,
"Department of Agriculture, Cooperation and Farmers Welfare",2016,3,532,411,121,0.772556391,,,
"Department of Agriculture, Cooperation and Farmers Welfare",2016,4,555,396,159,0.713513514,,,
"Department of Agriculture, Cooperation and Farmers Welfare",2016,5,427,681,-254,1.594847775,,,
"Department of Agriculture, Cooperation and Farmers Welfare",2016,6,566,450,116,0.795053004,,,
"Department of Agriculture, Cooperation and Farmers Welfare",2016,7,410,501,-91,1.22195122,,,
"Department of Agriculture, Cooperation and Farmers Welfare",2016,8,449,277,172,0.616926503,,,
"Department of Agriculture, Cooperation and Farmers Welfare",2016,9,388,332,56,0.855670103,,,
"Department of Agriculture, Cooperation and Farmers Welfare",2016,10,378,378,0,1,,,
"Department of Agriculture, Cooperation and Farmers Welfare",2016,11,359,426,-67,1.186629526,,,
"Department of Agriculture, Cooperation and Farmers Welfare",2016,12,507,280,227,0.552268245,,,
"Department of Agriculture, Cooperation and Farmers Welfare",2017,1,483,652,-169,1.34989648,,,
"Department of Agriculture, Cooperation and Farmers Welfare",2017,2,403,435,-32,1.079404467,,,
"Department of Agriculture, Cooperation and Farmers Welfare",2017,3,591,383,208,0.648054146,,,
"Department of Agriculture, Cooperation and Farmers Welfare",2017,4,434,288,146,0.66359447,,,
"Department of Agriculture, Cooperation and Farmers Welfare",2017,5,441,649,-208,1.471655329,,,
"Department of Agriculture, Cooperation and Farmers Welfare",2017,6,474,234,240,0.493670886,,,
"Department of Agriculture, Cooperation and Farmers Welfare",2017,7,408,481,-73,1.178921569,,,
"Department of Agriculture, Cooperation and Farmers Welfare",2017,8,428,391,37,0.913551402,,,
"Department of Agriculture, Cooperation and Farmers Welfare",2017,9,347,287,60,0.827089337,,,
"Department of Agriculture, Cooperation and Farmers Welfare",2017,10,297,324,-27,1.090909091,,,
"Department of Agriculture, Cooperation and Farmers Welfare",2017,11,396,362,34,0.914141414,,,
"Department of Agriculture, Cooperation and Farmers Welfare",2017,12,412,425,-13,1.031553398,,,
"Department of Agriculture, Cooperation and Farmers Welfare",2018,1,337,260,77,0.771513353,,,
"Department of Agriculture, Cooperation and Farmers Welfare",2018,2,277,284,-7,1.025270758,,,
"Department of Agriculture, Cooperation and Farmers Welfare",2018,3,314,372,-58,1.184713376,,,
"Department of Agriculture, Cooperation and Farmers Welfare",2018,4,350,799,-449,2.282857143,,,
"Department of Agriculture, Cooperation and Farmers Welfare",2018,5,458,866,-408,1.890829694,,,
"Department of Agriculture, Cooperation and Farmers Welfare",2018,6,361,171,190,0.473684211,,,
"Department of Agriculture, Cooperation and Farmers Welfare",2018,7,487,362,125,0.743326489,,,
"Department of Agriculture, Cooperation and Farmers Welfare",2018,8,362,434,-72,1.198895028,,,
"Department of Agriculture, Cooperation and Farmers Welfare",2018,9,337,324,13,0.961424332,,,
"Department of Agriculture, Cooperation and Farmers Welfare",2018,10,403,461,-58,1.143920596,,,
"Department of Agriculture, Cooperation and Farmers Welfare",2018,11,292,246,46,0.842465753,,,
"Department of Agriculture, Cooperation and Farmers Welfare",2018,12,516,397,119,0.769379845,,,
"Department of Agriculture, Cooperation and Farmers Welfare",2019,1,480,592,-112,1.233333333,,,
"Department of Agriculture, Cooperation and Farmers Welfare",2019,2,457,637,-180,1.393873085,,,
"Department of Agriculture, Cooperation and Farmers Welfare",2019,3,536,458,78,0.854477612,,,
"Department of Agriculture, Cooperation and Farmers Welfare",2019,4,437,353,84,0.80778032,,,
"Department of Agriculture, Cooperation and Farmers Welfare",2019,5,402,656,-254,1.631840796,,,
"Department of Agriculture, Cooperation and Farmers Welfare",2019,6,690,401,289,0.58115942,,,
"Department of Agriculture, Cooperation and Farmers Welfare",2019,7,814,484,330,0.594594595,,,
"Department of Agriculture, Cooperation and Farmers Welfare",2019,8,654,616,38,0.941896024,,,
"Department of Agriculture, Cooperation and Farmers Welfare",2019,9,819,1167,-348,1.424908425,,,
"Department of Agriculture, Cooperation and Farmers Welfare",2019,10,721,556,165,0.771151179,,,
"Department of Agriculture, Cooperation and Farmers Welfare",2019,11,25,12,13,0.48,,,
"Department of Animal Husbandry, Dairying",2016,1,76,11,65,0.144736842,,,
"Department of Animal Husbandry, Dairying",2016,2,93,119,-26,1.279569892,,,
"Department of Animal Husbandry, Dairying",2016,3,85,91,-6,1.070588235,,,
"Department of Animal Husbandry, Dairying",2016,4,76,59,17,0.776315789,,,
"Department of Animal Husbandry, Dairying",2016,5,75,40,35,0.533333333,,,
"Department of Animal Husbandry, Dairying",2016,6,120,108,12,0.9,,,
"Department of Animal Husbandry, Dairying",2016,7,88,85,3,0.965909091,,,
"Department of Animal Husbandry, Dairying",2016,8,130,58,72,0.446153846,,,
"Department of Animal Husbandry, Dairying",2016,9,116,30,86,0.25862069,,,
"Department of Animal Husbandry, Dairying",2016,10,59,183,-124,3.101694915,,,
"Department of Animal Husbandry, Dairying",2016,11,77,62,15,0.805194805,,,
"Department of Animal Husbandry, Dairying",2016,12,88,56,32,0.636363636,,,
"Department of Animal Husbandry, Dairying",2017,1,103,54,49,0.524271845,,,
"Department of Animal Husbandry, Dairying",2017,2,82,44,38,0.536585366,,,
"Department of Animal Husbandry, Dairying",2017,3,134,65,69,0.485074627,,,
"Department of Animal Husbandry, Dairying",2017,4,105,269,-164,2.561904762,,,
"Department of Animal Husbandry, Dairying",2017,5,116,156,-40,1.344827586,,,
"Department of Animal Husbandry, Dairying",2017,6,121,110,11,0.909090909,,,
"Department of Animal Husbandry, Dairying",2017,7,126,69,57,0.547619048,,,
"Department of Animal Husbandry, Dairying",2017,8,104,122,-18,1.173076923,,,
"Department of Animal Husbandry, Dairying",2017,9,130,124,6,0.953846154,,,
"Department of Animal Husbandry, Dairying",2017,10,88,53,35,0.602272727,,,
"Department of Animal Husbandry, Dairying",2017,11,119,56,63,0.470588235,,,
"Department of Animal Husbandry, Dairying",2017,12,63,106,-43,1.682539683,,,
"Department of Animal Husbandry, Dairying",2018,1,51,65,-14,1.274509804,,,
"Department of Animal Husbandry, Dairying",2018,2,59,108,-49,1.830508475,,,
"Department of Animal Husbandry, Dairying",2018,3,75,49,26,0.653333333,,,
"Department of Animal Husbandry, Dairying",2018,4,83,108,-25,1.301204819,,,
"Department of Animal Husbandry, Dairying",2018,5,119,75,44,0.630252101,,,
"Department of Animal Husbandry, Dairying",2018,6,184,105,79,0.570652174,,,
"Department of Animal Husbandry, Dairying",2018,7,320,365,-45,1.140625,,,
"Department of Animal Husbandry, Dairying",2018,8,91,136,-45,1.494505495,,,
"Department of Animal Husbandry, Dairying",2018,9,73,58,15,0.794520548,,,
"Department of Animal Husbandry, Dairying",2018,10,80,60,20,0.75,,,
"Department of Animal Husbandry, Dairying",2018,11,73,46,27,0.630136986,,,
"Department of Animal Husbandry, Dairying",2018,12,75,77,-2,1.026666667,,,
"Department of Animal Husbandry, Dairying",2019,1,103,35,68,0.339805825,,,
"Department of Animal Husbandry, Dairying",2019,2,89,103,-14,1.157303371,,,
"Department of Animal Husbandry, Dairying",2019,3,107,50,57,0.46728972,,,
"Department of Animal Husbandry, Dairying",2019,4,46,174,-128,3.782608696,,,
"Department of Animal Husbandry, Dairying",2019,5,80,73,7,0.9125,,,
"Department of Animal Husbandry, Dairying",2019,6,110,44,66,0.4,,,
"Department of Animal Husbandry, Dairying",2019,7,140,52,88,0.371428571,,,
"Department of Animal Husbandry, Dairying",2019,8,212,438,-226,2.066037736,,,
"Department of Animal Husbandry, Dairying",2019,9,167,159,8,0.952095808,,,
"Department of Animal Husbandry, Dairying",2019,10,102,175,-73,1.715686275,,,
Department of Atomic Energy,2016,1,84,21,63,0.25,,,
Department of Atomic Energy,2016,2,114,60,54,0.526315789,,,
Department of Atomic Energy,2016,3,120,131,-11,1.091666667,,,
Department of Atomic Energy,2016,4,134,63,71,0.470149254,,,
Department of Atomic Energy,2016,5,149,123,26,0.825503356,,,
Department of Atomic Energy,2016,6,158,158,0,1,,,
Department of Atomic Energy,2016,7,107,80,27,0.747663551,,,
Department of Atomic Energy,2016,8,150,189,-39,1.26,,,
Department of Atomic Energy,2016,9,192,131,61,0.682291667,,,
Department of Atomic Energy,2016,10,109,94,15,0.862385321,,,
Department of Atomic Energy,2016,11,87,58,29,0.666666667,,,
Department of Atomic Energy,2016,12,113,69,44,0.610619469,,,
Department of Atomic Energy,2017,1,99,70,29,0.707070707,,,
Department of Atomic Energy,2017,2,91,42,49,0.461538462,,,
Department of Atomic Energy,2017,3,142,137,5,0.964788732,,,
Department of Atomic Energy,2017,4,121,184,-63,1.520661157,,,
Department of Atomic Energy,2017,5,166,186,-20,1.120481928,,,
Department of Atomic Energy,2017,6,100,64,36,0.64,,,
Department of Atomic Energy,2017,7,133,120,13,0.902255639,,,
Department of Atomic Energy,2017,8,98,54,44,0.551020408,,,
Department of Atomic Energy,2017,9,97,92,5,0.948453608,,,
Department of Atomic Energy,2017,10,80,149,-69,1.8625,,,
Department of Atomic Energy,2017,11,94,142,-48,1.510638298,,,
Department of Atomic Energy,2017,12,79,83,-4,1.050632911,,,
Department of Atomic Energy,2018,1,101,70,31,0.693069307,,,
Department of Atomic Energy,2018,2,88,78,10,0.886363636,,,
Department of Atomic Energy,2018,3,67,82,-15,1.223880597,,,
Department of Atomic Energy,2018,4,210,122,88,0.580952381,,,
Department of Atomic Energy,2018,5,323,148,175,0.458204334,,,
Department of Atomic Energy,2018,6,81,105,-24,1.296296296,,,
Department of Atomic Energy,2018,7,102,127,-25,1.245098039,,,
Department of Atomic Energy,2018,8,125,98,27,0.784,,,
Department of Atomic Energy,2018,9,110,61,49,0.554545455,,,
Department of Atomic Energy,2018,10,124,116,8,0.935483871,,,
Department of Atomic Energy,2018,11,63,81,-18,1.285714286,,,
Department of Atomic Energy,2018,12,154,74,80,0.480519481,,,
Department of Atomic Energy,2019,1,383,163,220,0.425587467,,,
Department of Atomic Energy,2019,2,156,312,-156,2,,,
Department of Atomic Energy,2019,3,136,224,-88,1.647058824,,,
Department of Atomic Energy,2019,4,113,108,5,0.955752212,,,
Department of Atomic Energy,2019,5,120,73,47,0.608333333,,,
Department of Atomic Energy,2019,6,108,79,29,0.731481481,,,
Department of Atomic Energy,2019,7,116,108,8,0.931034483,,,
Department of Atomic Energy,2019,8,111,268,-157,2.414414414,,,
Department of Atomic Energy,2019,9,125,91,34,0.728,,,
Department of Atomic Energy,2019,10,80,179,-99,2.2375,,,
Department of Atomic Energy,2019,11,1,17,-16,17,,,
Department of Bio Technology,2016,3,16,3,13,0.1875,,,
Department of Bio Technology,2016,4,16,7,9,0.4375,,,
Department of Bio Technology,2016,5,23,9,14,0.391304348,,,
Department of Bio Technology,2016,6,25,29,-4,1.16,,,
Department of Bio Technology,2016,7,23,21,2,0.913043478,,,
Department of Bio Technology,2016,8,18,18,0,1,,,
Department of Bio Technology,2016,9,29,17,12,0.586206897,,,
Department of Bio Technology,2016,10,14,11,3,0.785714286,,,
Department of Bio Technology,2016,11,11,23,-12,2.090909091,,,
Department of Bio Technology,2016,12,25,9,16,0.36,,,
Department of Bio Technology,2017,1,20,16,4,0.8,,,
Department of Bio Technology,2017,2,9,13,-4,1.444444444,,,
Department of Bio Technology,2017,3,17,12,5,0.705882353,,,
Department of Bio Technology,2017,4,21,5,16,0.238095238,,,
Department of Bio Technology,2017,5,31,28,3,0.903225806,,,
Department of Bio Technology,2017,6,19,15,4,0.789473684,,,
Department of Bio Technology,2017,7,27,22,5,0.814814815,,,
Department of Bio Technology,2017,8,16,16,0,1,,,
Department of Bio Technology,2017,9,18,7,11,0.388888889,,,
Department of Bio Technology,2017,11,29,24,5,0.827586207,,,
Department of Bio Technology,2017,12,15,24,-9,1.6,,,
Department of Bio Technology,2018,1,14,12,2,0.857142857,,,
Department of Bio Technology,2018,2,6,6,0,1,,,
Department of Bio Technology,2018,3,10,14,-4,1.4,,,
Department of Bio Technology,2018,4,34,18,16,0.529411765,,,
Department of Bio Technology,2018,5,63,133,-70,2.111111111,,,
Department of Bio Technology,2018,6,9,19,-10,2.111111111,,,
Department of Bio Technology,2018,7,21,29,-8,1.380952381,,,
Department of Bio Technology,2018,8,17,11,6,0.647058824,,,
Department of Bio Technology,2018,9,5,8,-3,1.6,,,
Department of Bio Technology,2018,10,12,9,3,0.75,,,
Department of Bio Technology,2018,11,10,4,6,0.4,,,
Department of Bio Technology,2018,12,34,2,32,0.058823529,,,
Department of Bio Technology,2019,1,34,48,-14,1.411764706,,,
Department of Bio Technology,2019,2,33,29,4,0.878787879,,,
Department of Bio Technology,2019,3,47,43,4,0.914893617,,,
Department of Bio Technology,2019,4,25,15,10,0.6,,,
Department of Bio Technology,2019,5,8,7,1,0.875,,,
Department of Bio Technology,2019,6,17,59,-42,3.470588235,,,
Department of Bio Technology,2019,7,21,25,-4,1.19047619,,,
Department of Bio Technology,2019,8,15,23,-8,1.533333333,,,
Department of Bio Technology,2019,9,24,38,-14,1.583333333,,,
Department of Bio Technology,2019,10,21,25,-4,1.19047619,,,
Department of Chemicals and Petrochemicals,2016,1,39,19,20,0.487179487,,,
Department of Chemicals and Petrochemicals,2016,2,42,24,18,0.571428571,,,
Department of Chemicals and Petrochemicals,2016,3,34,47,-13,1.382352941,,,
Department of Chemicals and Petrochemicals,2016,4,37,36,1,0.972972973,,,
Department of Chemicals and Petrochemicals,2016,5,34,21,13,0.617647059,,,
Department of Chemicals and Petrochemicals,2016,6,29,53,-24,1.827586207,,,
Department of Chemicals and Petrochemicals,2016,7,36,34,2,0.944444444,,,
Department of Chemicals and Petrochemicals,2016,8,29,30,-1,1.034482759,,,
Department of Chemicals and Petrochemicals,2016,9,39,26,13,0.666666667,,,
Department of Chemicals and Petrochemicals,2016,10,33,29,4,0.878787879,,,
Department of Chemicals and Petrochemicals,2016,11,30,35,-5,1.166666667,,,
Department of Chemicals and Petrochemicals,2016,12,45,29,16,0.644444444,,,
Department of Chemicals and Petrochemicals,2017,1,32,43,-11,1.34375,,,
Department of Chemicals and Petrochemicals,2017,2,45,29,16,0.644444444,,,
Department of Chemicals and Petrochemicals,2017,3,38,48,-10,1.263157895,,,
Department of Chemicals and Petrochemicals,2017,4,41,45,-4,1.097560976,,,
Department of Chemicals and Petrochemicals,2017,5,59,60,-1,1.016949153,,,
Department of Chemicals and Petrochemicals,2017,6,38,43,-5,1.131578947,,,
Department of Chemicals and Petrochemicals,2017,7,48,59,-11,1.229166667,,,
Department of Chemicals and Petrochemicals,2017,8,39,31,8,0.794871795,,,
Department of Chemicals and Petrochemicals,2017,9,31,34,-3,1.096774194,,,
Department of Chemicals and Petrochemicals,2017,10,32,43,-11,1.34375,,,
Department of Chemicals and Petrochemicals,2017,11,43,28,15,0.651162791,,,
Department of Chemicals and Petrochemicals,2017,12,42,40,2,0.952380952,,,
Department of Chemicals and Petrochemicals,2018,1,20,38,-18,1.9,,,
Department of Chemicals and Petrochemicals,2018,2,22,25,-3,1.136363636,,,
Department of Chemicals and Petrochemicals,2018,3,34,25,9,0.735294118,,,
Department of Chemicals and Petrochemicals,2018,4,39,32,7,0.820512821,,,
Department of Chemicals and Petrochemicals,2018,5,80,94,-14,1.175,,,
Department of Chemicals and Petrochemicals,2018,6,22,21,1,0.954545455,,,
Department of Chemicals and Petrochemicals,2018,7,28,24,4,0.857142857,,,
Department of Chemicals and Petrochemicals,2018,8,37,44,-7,1.189189189,,,
Department of Chemicals and Petrochemicals,2018,9,33,33,0,1,,,
Department of Chemicals and Petrochemicals,2018,10,89,46,43,0.516853933,,,
Department of Chemicals and Petrochemicals,2018,11,286,333,-47,1.164335664,,,
Department of Chemicals and Petrochemicals,2018,12,60,52,8,0.866666667,,,
Department of Chemicals and Petrochemicals,2019,1,47,57,-10,1.212765957,,,
Department of Chemicals and Petrochemicals,2019,2,30,29,1,0.966666667,,,
Department of Chemicals and Petrochemicals,2019,3,53,49,4,0.924528302,,,
Department of Chemicals and Petrochemicals,2019,4,31,28,3,0.903225806,,,
Department of Chemicals and Petrochemicals,2019,5,32,37,-5,1.15625,,,
Department of Chemicals and Petrochemicals,2019,6,43,36,7,0.837209302,,,
Department of Chemicals and Petrochemicals,2019,7,46,49,-3,1.065217391,,,
Department of Chemicals and Petrochemicals,2019,8,37,34,3,0.918918919,,,
Department of Chemicals and Petrochemicals,2019,9,49,48,1,0.979591837,,,
Department of Chemicals and Petrochemicals,2019,10,58,56,2,0.965517241,,,
Department of Commerce,2016,1,326,173,153,0.530674847,,,
Department of Commerce,2016,2,321,293,28,0.912772586,,,
Department of Commerce,2016,3,303,305,-2,1.00660066,,,
Department of Commerce,2016,4,378,306,72,0.80952381,,,
Department of Commerce,2016,5,279,359,-80,1.286738351,,,
Department of Commerce,2016,6,390,386,4,0.98974359,,,
Department of Commerce,2016,7,295,318,-23,1.077966102,,,
Department of Commerce,2016,8,328,312,16,0.951219512,,,
Department of Commerce,2016,9,289,295,-6,1.020761246,,,
Department of Commerce,2016,10,438,365,73,0.833333333,,,
Department of Commerce,2016,11,391,338,53,0.864450128,,,
Department of Commerce,2016,12,397,334,63,0.841309824,,,
Department of Commerce,2017,1,320,316,4,0.9875,,,
Department of Commerce,2017,2,282,326,-44,1.156028369,,,
Department of Commerce,2017,3,372,436,-64,1.172043011,,,
Department of Commerce,2017,4,287,268,19,0.933797909,,,
Department of Commerce,2017,5,344,386,-42,1.122093023,,,
Department of Commerce,2017,6,389,415,-26,1.066838046,,,
Department of Commerce,2017,7,500,503,-3,1.006,,,
Department of Commerce,2017,8,335,408,-73,1.217910448,,,
Department of Commerce,2017,9,343,345,-2,1.005830904,,,
Department of Commerce,2017,10,304,291,13,0.957236842,,,
Department of Commerce,2017,11,334,288,46,0.862275449,,,
Department of Commerce,2017,12,261,274,-13,1.049808429,,,
Department of Commerce,2018,1,243,295,-52,1.21399177,,,
Department of Commerce,2018,2,214,181,33,0.845794393,,,
Department of Commerce,2018,3,262,226,36,0.86259542,,,
Department of Commerce,2018,4,270,259,11,0.959259259,,,
Department of Commerce,2018,5,351,345,6,0.982905983,,,
Department of Commerce,2018,6,399,202,197,0.506265664,,,
Department of Commerce,2018,7,592,740,-148,1.25,,,
Department of Commerce,2018,8,341,360,-19,1.055718475,,,
Department of Commerce,2018,9,308,253,55,0.821428571,,,
Department of Commerce,2018,10,336,360,-24,1.071428571,,,
Department of Commerce,2018,11,250,254,-4,1.016,,,
Department of Commerce,2018,12,258,264,-6,1.023255814,,,
Department of Commerce,2019,1,343,401,-58,1.16909621,,,
Department of Commerce,2019,2,273,292,-19,1.06959707,,,
Department of Commerce,2019,3,306,293,13,0.95751634,,,
Department of Commerce,2019,4,264,276,-12,1.045454545,,,
Department of Commerce,2019,5,270,299,-29,1.107407407,,,
Department of Commerce,2019,6,345,298,47,0.863768116,,,
Department of Commerce,2019,7,401,360,41,0.897755611,,,
Department of Commerce,2019,8,335,336,-1,1.002985075,,,
Department of Commerce,2019,9,397,377,20,0.949622166,,,
Department of Commerce,2019,10,373,363,10,0.973190349,,,
Department of Commerce,2019,11,19,16,3,0.842105263,,,
Department of Consumer Affairs,2016,1,339,24,315,0.07079646,,,
Department of Consumer Affairs,2016,2,417,431,-14,1.033573141,,,
Department of Consumer Affairs,2016,3,403,458,-55,1.136476427,,,
Department of Consumer Affairs,2016,4,422,299,123,0.708530806,,,
Department of Consumer Affairs,2016,5,435,388,47,0.891954023,,,
Department of Consumer Affairs,2016,6,536,466,70,0.869402985,,,
Department of Consumer Affairs,2016,7,366,261,105,0.713114754,,,
Department of Consumer Affairs,2016,8,428,730,-302,1.705607477,,,
Department of Consumer Affairs,2016,9,522,436,86,0.835249042,,,
Department of Consumer Affairs,2016,10,613,296,317,0.482871126,,,
Department of Consumer Affairs,2016,11,621,674,-53,1.085346216,,,
Department of Consumer Affairs,2016,12,724,539,185,0.744475138,,,
Department of Consumer Affairs,2017,1,840,935,-95,1.113095238,,,
Department of Consumer Affairs,2017,2,620,778,-158,1.25483871,,,
Department of Consumer Affairs,2017,3,773,772,1,0.998706339,,,
Department of Consumer Affairs,2017,4,587,652,-65,1.110732538,,,
Department of Consumer Affairs,2017,5,776,784,-8,1.010309278,,,
Department of Consumer Affairs,2017,6,758,808,-50,1.065963061,,,
Department of Consumer Affairs,2017,7,903,793,110,0.878183832,,,
Department of Consumer Affairs,2017,8,804,823,-19,1.023631841,,,
Department of Consumer Affairs,2017,9,539,691,-152,1.282003711,,,
Department of Consumer Affairs,2017,10,675,558,117,0.826666667,,,
Department of Consumer Affairs,2017,11,769,582,187,0.756827048,,,
Department of Consumer Affairs,2017,12,512,699,-187,1.365234375,,,
Department of Consumer Affairs,2018,1,507,573,-66,1.130177515,,,
Department of Consumer Affairs,2018,2,480,519,-39,1.08125,,,
Department of Consumer Affairs,2018,3,553,435,118,0.786618445,,,
Department of Consumer Affairs,2018,4,562,622,-60,1.106761566,,,
Department of Consumer Affairs,2018,5,854,708,146,0.829039813,,,
Department of Consumer Affairs,2018,6,559,523,36,0.935599284,,,
Department of Consumer Affairs,2018,7,1096,971,125,0.885948905,,,
Department of Consumer Affairs,2018,8,752,723,29,0.96143617,,,
Department of Consumer Affairs,2018,9,720,821,-101,1.140277778,,,
Department of Consumer Affairs,2018,10,751,747,4,0.994673768,,,
Department of Consumer Affairs,2018,11,644,629,15,0.976708075,,,
Department of Consumer Affairs,2018,12,613,871,-258,1.420880914,,,
Department of Consumer Affairs,2019,1,749,876,-127,1.169559413,,,
Department of Consumer Affairs,2019,2,684,718,-34,1.049707602,,,
Department of Consumer Affairs,2019,3,641,547,94,0.853354134,,,
Department of Consumer Affairs,2019,4,678,692,-14,1.020648968,,,
Department of Consumer Affairs,2019,5,908,746,162,0.821585903,,,
Department of Consumer Affairs,2019,6,937,888,49,0.947705443,,,
Department of Consumer Affairs,2019,7,1401,1168,233,0.833690221,,,
Department of Consumer Affairs,2019,8,905,876,29,0.967955801,,,
Department of Consumer Affairs,2019,9,1135,1274,-139,1.12246696,,,
Department of Consumer Affairs,2019,10,1117,1078,39,0.965085049,,,
Department of Consumer Affairs,2019,11,34,29,5,0.852941176,,,
Department of Defence,2016,1,1239,415,824,0.334947538,,,
Department of Defence,2016,2,1240,775,465,0.625,,,
Department of Defence,2016,3,1086,1079,7,0.993554328,,,
Department of Defence,2016,4,1105,877,228,0.793665158,,,
Department of Defence,2016,5,1110,1278,-168,1.151351351,,,
Department of Defence,2016,6,1325,1102,223,0.831698113,,,
Department of Defence,2016,7,1283,1018,265,0.793452845,,,
Department of Defence,2016,8,1565,602,963,0.384664537,,,
Department of Defence,2016,9,1837,1393,444,0.758301579,,,
Department of Defence,2016,10,1735,1580,155,0.910662824,,,
Department of Defence,2016,11,1508,1737,-229,1.151856764,,,
Department of Defence,2016,12,1622,858,764,0.528976572,,,
Department of Defence,2017,1,1301,1530,-229,1.176018447,,,
Department of Defence,2017,2,1008,1003,5,0.995039683,,,
Department of Defence,2017,3,1255,1934,-679,1.541035857,,,
Department of Defence,2017,4,1247,1247,0,1,,,
Department of Defence,2017,5,1522,1677,-155,1.101839685,,,
Department of Defence,2017,6,1183,1193,-10,1.008453085,,,
Department of Defence,2017,7,1308,1747,-439,1.335626911,,,
Department of Defence,2017,8,1249,1093,156,0.87510008,,,
Department of Defence,2017,9,1001,1140,-139,1.138861139,,,
Department of Defence,2017,10,860,794,66,0.923255814,,,
Department of Defence,2017,11,1020,896,124,0.878431373,,,
Department of Defence,2017,12,983,899,84,0.914547304,,,
Department of Defence,2018,1,796,883,-87,1.109296482,,,
Department of Defence,2018,2,849,851,-2,1.002355713,,,
Department of Defence,2018,3,1054,1236,-182,1.172675522,,,
Department of Defence,2018,4,948,897,51,0.946202532,,,
Department of Defence,2018,5,1302,1907,-605,1.464669739,,,
Department of Defence,2018,6,1076,727,349,0.675650558,,,
Department of Defence,2018,7,1439,1239,200,0.861014593,,,
Department of Defence,2018,8,1235,946,289,0.765991903,,,
Department of Defence,2018,9,1272,1327,-55,1.043238994,,,
Department of Defence,2018,10,1640,1461,179,0.890853659,,,
Department of Defence,2018,11,1233,795,438,0.644768856,,,
Department of Defence,2018,12,1536,1143,393,0.744140625,,,
Department of Defence,2019,1,1724,1502,222,0.871229698,,,
Department of Defence,2019,2,1805,2420,-615,1.340720222,,,
Department of Defence,2019,3,1294,935,359,0.722565688,,,
Department of Defence,2019,4,934,1091,-157,1.168094218,,,
Department of Defence,2019,5,853,927,-74,1.086752638,,,
Department of Defence,2019,6,1169,905,264,0.774165954,,,
Department of Defence,2019,7,1309,966,343,0.737967914,,,
Department of Defence,2019,8,1107,2131,-1024,1.925022584,,,
Department of Defence,2019,9,1108,1144,-36,1.032490975,,,
Department of Defence,2019,10,967,1105,-138,1.142709411,,,
Department of Defence,2019,11,27,53,-26,1.962962963,,,
Department of Defence Finance,2016,1,178,111,67,0.623595506,,,
Department of Defence Finance,2016,2,269,139,130,0.516728625,,,
Department of Defence Finance,2016,3,202,109,93,0.53960396,,,
Department of Defence Finance,2016,4,202,151,51,0.747524752,,,
Department of Defence Finance,2016,5,208,104,104,0.5,,,
Department of Defence Finance,2016,6,228,151,77,0.662280702,,,
Department of Defence Finance,2016,7,212,224,-12,1.056603774,,,
Department of Defence Finance,2016,8,206,173,33,0.839805825,,,
Department of Defence Finance,2016,9,340,235,105,0.691176471,,,
Department of Defence Finance,2016,10,338,221,117,0.653846154,,,
Department of Defence Finance,2016,11,314,266,48,0.847133758,,,
Department of Defence Finance,2016,12,259,367,-108,1.416988417,,,
Department of Defence Finance,2017,1,274,383,-109,1.397810219,,,
Department of Defence Finance,2017,2,230,289,-59,1.256521739,,,
Department of Defence Finance,2017,3,275,264,11,0.96,,,
Department of Defence Finance,2017,4,279,300,-21,1.075268817,,,
Department of Defence Finance,2017,5,376,259,117,0.688829787,,,
Department of Defence Finance,2017,6,323,374,-51,1.157894737,,,
Department of Defence Finance,2017,7,423,422,1,0.997635934,,,
Department of Defence Finance,2017,8,583,379,204,0.650085763,,,
Department of Defence Finance,2017,9,552,425,127,0.769927536,,,
Department of Defence Finance,2017,10,503,316,187,0.628230616,,,
Department of Defence Finance,2017,11,452,527,-75,1.165929204,,,
Department of Defence Finance,2017,12,440,938,-498,2.131818182,,,
Department of Defence Finance,2018,1,403,438,-35,1.086848635,,,
Department of Defence Finance,2018,2,368,396,-28,1.076086957,,,
Department of Defence Finance,2018,3,752,331,421,0.440159574,,,
Department of Defence Finance,2018,4,838,515,323,0.614558473,,,
Department of Defence Finance,2018,5,896,1152,-256,1.285714286,,,
Department of Defence Finance,2018,6,464,683,-219,1.471982759,,,
Department of Defence Finance,2018,7,803,714,89,0.889165629,,,
Department of Defence Finance,2018,8,1082,714,368,0.659889094,,,
Department of Defence Finance,2018,9,891,826,65,0.92704826,,,
Department of Defence Finance,2018,10,1201,1120,81,0.932556203,,,
Department of Defence Finance,2018,11,995,997,-2,1.00201005,,,
Department of Defence Finance,2018,12,1314,1337,-23,1.017503805,,,
Department of Defence Finance,2019,1,1845,2005,-160,1.086720867,,,
Department of Defence Finance,2019,2,891,984,-93,1.104377104,,,
Department of Defence Finance,2019,3,760,839,-79,1.103947368,,,
Department of Defence Finance,2019,4,904,898,6,0.993362832,,,
Department of Defence Finance,2019,5,810,977,-167,1.20617284,,,
Department of Defence Finance,2019,6,1105,663,442,0.6,,,
Department of Defence Finance,2019,7,1308,1288,20,0.98470948,,,
Department of Defence Finance,2019,8,1209,1029,180,0.851116625,,,
Department of Defence Finance,2019,9,1018,1028,-10,1.009823183,,,
Department of Defence Finance,2019,10,820,966,-146,1.17804878,,,
Department of Defence Finance,2019,11,16,13,3,0.8125,,,
Department of Defence Production,2016,1,115,33,82,0.286956522,,,
Department of Defence Production,2016,2,169,107,62,0.633136095,,,
Department of Defence Production,2016,3,334,325,9,0.973053892,,,
Department of Defence Production,2016,4,252,165,87,0.654761905,,,
Department of Defence Production,2016,5,195,228,-33,1.169230769,,,
Department of Defence Production,2016,6,230,243,-13,1.056521739,,,
Department of Defence Production,2016,7,168,235,-67,1.398809524,,,
Department of Defence Production,2016,8,125,159,-34,1.272,,,
Department of Defence Production,2016,9,157,127,30,0.808917197,,,
Department of Defence Production,2016,10,228,138,90,0.605263158,,,
Department of Defence Production,2016,11,1011,445,566,0.440158259,,,
Department of Defence Production,2016,12,185,840,-655,4.540540541,,,
Department of Defence Production,2017,1,159,157,2,0.987421384,,,
Department of Defence Production,2017,2,163,139,24,0.852760736,,,
Department of Defence Production,2017,3,239,234,5,0.979079498,,,
Department of Defence Production,2017,4,166,169,-3,1.018072289,,,
Department of Defence Production,2017,5,223,213,10,0.955156951,,,
Department of Defence Production,2017,6,208,201,7,0.966346154,,,
Department of Defence Production,2017,7,220,182,38,0.827272727,,,
Department of Defence Production,2017,8,168,211,-43,1.255952381,,,
Department of Defence Production,2017,9,171,138,33,0.807017544,,,
Department of Defence Production,2017,10,130,106,24,0.815384615,,,
Department of Defence Production,2017,11,188,152,36,0.808510638,,,
Department of Defence Production,2017,12,164,239,-75,1.457317073,,,
Department of Defence Production,2018,1,157,238,-81,1.515923567,,,
Department of Defence Production,2018,2,125,146,-21,1.168,,,
Department of Defence Production,2018,3,134,81,53,0.604477612,,,
Department of Defence Production,2018,4,164,138,26,0.841463415,,,
Department of Defence Production,2018,5,219,262,-43,1.196347032,,,
Department of Defence Production,2018,6,193,219,-26,1.134715026,,,
Department of Defence Production,2018,7,250,187,63,0.748,,,
Department of Defence Production,2018,8,244,241,3,0.987704918,,,
Department of Defence Production,2018,9,192,238,-46,1.239583333,,,
Department of Defence Production,2018,10,175,183,-8,1.045714286,,,
Department of Defence Production,2018,11,153,158,-5,1.032679739,,,
Department of Defence Production,2018,12,172,161,11,0.936046512,,,
Department of Defence Production,2019,1,180,214,-34,1.188888889,,,
Department of Defence Production,2019,2,173,166,7,0.959537572,,,
Department of Defence Production,2019,3,162,133,29,0.820987654,,,
Department of Defence Production,2019,4,139,176,-37,1.26618705,,,
Department of Defence Production,2019,5,115,136,-21,1.182608696,,,
Department of Defence Production,2019,6,160,111,49,0.69375,,,
Department of Defence Production,2019,7,188,188,0,1,,,
Department of Defence Production,2019,8,215,180,35,0.837209302,,,
Department of Defence Production,2019,9,197,246,-49,1.248730964,,,
Department of Defence Production,2019,10,177,186,-9,1.050847458,,,
Department of Defence Production,2019,11,2,2,0,1,,,
Department of Defence Research and Development,2016,1,33,26,7,0.787878788,,,
Department of Defence Research and Development,2016,2,83,60,23,0.722891566,,,
Department of Defence Research and Development,2016,3,68,74,-6,1.088235294,,,
Department of Defence Research and Development,2016,4,59,59,0,1,,,
Department of Defence Research and Development,2016,5,40,46,-6,1.15,,,
Department of Defence Research and Development,2016,6,78,73,5,0.935897436,,,
Department of Defence Research and Development,2016,7,61,60,1,0.983606557,,,
Department of Defence Research and Development,2016,8,56,47,9,0.839285714,,,
Department of Defence Research and Development,2016,9,52,58,-6,1.115384615,,,
Department of Defence Research and Development,2016,10,73,77,-4,1.054794521,,,
Department of Defence Research and Development,2016,11,51,50,1,0.980392157,,,
Department of Defence Research and Development,2016,12,63,61,2,0.968253968,,,
Department of Defence Research and Development,2017,1,50,55,-5,1.1,,,
Department of Defence Research and Development,2017,2,60,61,-1,1.016666667,,,
Department of Defence Research and Development,2017,3,95,91,4,0.957894737,,,
Department of Defence Research and Development,2017,4,46,58,-12,1.260869565,,,
Department of Defence Research and Development,2017,5,80,51,29,0.6375,,,
Department of Defence Research and Development,2017,6,97,111,-14,1.144329897,,,
Department of Defence Research and Development,2017,7,96,109,-13,1.135416667,,,
Department of Defence Research and Development,2017,8,76,71,5,0.934210526,,,
Department of Defence Research and Development,2017,9,56,50,6,0.892857143,,,
Department of Defence Research and Development,2017,10,43,45,-2,1.046511628,,,
Department of Defence Research and Development,2017,11,53,58,-5,1.094339623,,,
Department of Defence Research and Development,2017,12,45,43,2,0.955555556,,,
Department of Defence Research and Development,2018,1,44,48,-4,1.090909091,,,
Department of Defence Research and Development,2018,2,39,43,-4,1.102564103,,,
Department of Defence Research and Development,2018,3,44,47,-3,1.068181818,,,
Department of Defence Research and Development,2018,4,59,43,16,0.728813559,,,
Department of Defence Research and Development,2018,5,90,100,-10,1.111111111,,,
Department of Defence Research and Development,2018,6,48,35,13,0.729166667,,,
Department of Defence Research and Development,2018,7,68,44,24,0.647058824,,,
Department of Defence Research and Development,2018,8,107,129,-22,1.205607477,,,
Department of Defence Research and Development,2018,9,69,87,-18,1.260869565,,,
Department of Defence Research and Development,2018,10,57,45,12,0.789473684,,,
Department of Defence Research and Development,2018,11,61,56,5,0.918032787,,,
Department of Defence Research and Development,2018,12,90,80,10,0.888888889,,,
Department of Defence Research and Development,2019,1,65,76,-11,1.169230769,,,
Department of Defence Research and Development,2019,2,143,116,27,0.811188811,,,
Department of Defence Research and Development,2019,3,134,128,6,0.955223881,,,
Department of Defence Research and Development,2019,4,65,83,-18,1.276923077,,,
Department of Defence Research and Development,2019,5,56,65,-9,1.160714286,,,
Department of Defence Research and Development,2019,6,68,47,21,0.691176471,,,
Department of Defence Research and Development,2019,7,48,65,-17,1.354166667,,,
Department of Defence Research and Development,2019,8,71,51,20,0.718309859,,,
Department of Defence Research and Development,2019,9,97,99,-2,1.020618557,,,
Department of Defence Research and Development,2019,10,60,104,-44,1.733333333,,,
Department of Economic Affairs ACC Division,2016,1,241,59,182,0.244813278,,,
Department of Economic Affairs ACC Division,2016,2,299,146,153,0.488294314,,,
Department of Economic Affairs ACC Division,2016,3,314,185,129,0.589171975,,,
Department of Economic Affairs ACC Division,2016,4,257,215,42,0.836575875,,,
Department of Economic Affairs ACC Division,2016,5,206,329,-123,1.597087379,,,
Department of Economic Affairs ACC Division,2016,6,203,270,-67,1.330049261,,,
Department of Economic Affairs ACC Division,2016,7,164,169,-5,1.030487805,,,
Department of Economic Affairs ACC Division,2016,8,174,196,-22,1.126436782,,,
Department of Economic Affairs ACC Division,2016,9,176,165,11,0.9375,,,
Department of Economic Affairs ACC Division,2016,10,165,125,40,0.757575758,,,
Department of Economic Affairs ACC Division,2016,11,1068,256,812,0.239700375,,,
Department of Economic Affairs ACC Division,2016,12,2331,389,1942,0.166881167,,,
Department of Economic Affairs ACC Division,2017,1,1240,832,408,0.670967742,,,
Department of Economic Affairs ACC Division,2017,2,983,509,474,0.517802645,,,
Department of Economic Affairs ACC Division,2017,3,1403,1563,-160,1.11404134,,,
Department of Economic Affairs ACC Division,2017,4,291,910,-619,3.127147766,,,
Department of Economic Affairs ACC Division,2017,5,437,1909,-1472,4.368421053,,,
Department of Economic Affairs ACC Division,2017,6,414,282,132,0.68115942,,,
Department of Economic Affairs ACC Division,2017,7,516,588,-72,1.139534884,,,
Department of Economic Affairs ACC Division,2017,8,261,307,-46,1.176245211,,,
Department of Economic Affairs ACC Division,2017,9,243,443,-200,1.823045267,,,
Department of Economic Affairs ACC Division,2017,10,190,210,-20,1.105263158,,,
Department of Economic Affairs ACC Division,2017,11,301,270,31,0.897009967,,,
Department of Economic Affairs ACC Division,2017,12,184,765,-581,4.157608696,,,
Department of Economic Affairs ACC Division,2018,1,234,548,-314,2.341880342,,,
Department of Economic Affairs ACC Division,2018,2,175,242,-67,1.382857143,,,
Department of Economic Affairs ACC Division,2018,3,144,214,-70,1.486111111,,,
Department of Economic Affairs ACC Division,2018,4,208,181,27,0.870192308,,,
Department of Economic Affairs ACC Division,2018,5,294,338,-44,1.149659864,,,
Department of Economic Affairs ACC Division,2018,6,146,518,-372,3.547945205,,,
Department of Economic Affairs ACC Division,2018,7,208,184,24,0.884615385,,,
Department of Economic Affairs ACC Division,2018,8,224,295,-71,1.316964286,,,
Department of Economic Affairs ACC Division,2018,9,187,164,23,0.877005348,,,
Department of Economic Affairs ACC Division,2018,10,215,171,44,0.795348837,,,
Department of Economic Affairs ACC Division,2018,11,184,243,-59,1.320652174,,,
Department of Economic Affairs ACC Division,2018,12,186,182,4,0.978494624,,,
Department of Economic Affairs ACC Division,2019,1,233,164,69,0.703862661,,,
Department of Economic Affairs ACC Division,2019,2,337,312,25,0.925816024,,,
Department of Economic Affairs ACC Division,2019,3,239,299,-60,1.251046025,,,
Department of Economic Affairs ACC Division,2019,4,169,155,14,0.917159763,,,
Department of Economic Affairs ACC Division,2019,5,180,125,55,0.694444444,,,
Department of Economic Affairs ACC Division,2019,6,243,251,-8,1.032921811,,,
Department of Economic Affairs ACC Division,2019,7,214,224,-10,1.046728972,,,
Department of Economic Affairs ACC Division,2019,8,252,231,21,0.916666667,,,
Department of Economic Affairs ACC Division,2019,9,228,278,-50,1.219298246,,,
Department of Economic Affairs ACC Division,2019,10,194,182,12,0.93814433,,,
Department of Economic Affairs ACC Division,2019,11,7,17,-10,2.428571429,,,
Department of Empowerment of Persons with Disabilities,2016,1,200,136,64,0.68,,,
Department of Empowerment of Persons with Disabilities,2016,2,214,218,-4,1.018691589,,,
Department of Empowerment of Persons with Disabilities,2016,3,215,189,26,0.879069767,,,
Department of Empowerment of Persons with Disabilities,2016,4,217,218,-1,1.004608295,,,
Department of Empowerment of Persons with Disabilities,2016,5,194,234,-40,1.206185567,,,
Department of Empowerment of Persons with Disabilities,2016,6,445,250,195,0.561797753,,,
Department of Empowerment of Persons with Disabilities,2016,7,229,384,-155,1.676855895,,,
Department of Empowerment of Persons with Disabilities,2016,8,239,199,40,0.832635983,,,
Department of Empowerment of Persons with Disabilities,2016,9,197,216,-19,1.096446701,,,
Department of Empowerment of Persons with Disabilities,2016,10,170,126,44,0.741176471,,,
Department of Empowerment of Persons with Disabilities,2016,11,140,164,-24,1.171428571,,,
Department of Empowerment of Persons with Disabilities,2016,12,230,140,90,0.608695652,,,
Department of Empowerment of Persons with Disabilities,2017,1,176,260,-84,1.477272727,,,
Department of Empowerment of Persons with Disabilities,2017,2,128,143,-15,1.1171875,,,
Department of Empowerment of Persons with Disabilities,2017,3,184,114,70,0.619565217,,,
Department of Empowerment of Persons with Disabilities,2017,4,145,193,-48,1.331034483,,,
Department of Empowerment of Persons with Disabilities,2017,5,213,217,-4,1.018779343,,,
Department of Empowerment of Persons with Disabilities,2017,6,243,266,-23,1.094650206,,,
Department of Empowerment of Persons with Disabilities,2017,7,595,169,426,0.284033613,,,
Department of Empowerment of Persons with Disabilities,2017,8,274,276,-2,1.00729927,,,
Department of Empowerment of Persons with Disabilities,2017,9,313,405,-92,1.293929712,,,
Department of Empowerment of Persons with Disabilities,2017,10,142,84,58,0.591549296,,,
Department of Empowerment of Persons with Disabilities,2017,11,151,100,51,0.662251656,,,
Department of Empowerment of Persons with Disabilities,2017,12,167,479,-312,2.868263473,,,
Department of Empowerment of Persons with Disabilities,2018,1,147,274,-127,1.863945578,,,
Department of Empowerment of Persons with Disabilities,2018,2,121,68,53,0.561983471,,,
Department of Empowerment of Persons with Disabilities,2018,3,171,166,5,0.970760234,,,
Department of Empowerment of Persons with Disabilities,2018,4,168,71,97,0.422619048,,,
Department of Empowerment of Persons with Disabilities,2018,5,270,351,-81,1.3,,,
Department of Empowerment of Persons with Disabilities,2018,6,140,248,-108,1.771428571,,,
Department of Empowerment of Persons with Disabilities,2018,7,186,175,11,0.940860215,,,
Department of Empowerment of Persons with Disabilities,2018,8,194,123,71,0.634020619,,,
Department of Empowerment of Persons with Disabilities,2018,9,167,164,3,0.982035928,,,
Department of Empowerment of Persons with Disabilities,2018,10,152,149,3,0.980263158,,,
Department of Empowerment of Persons with Disabilities,2018,11,144,136,8,0.944444444,,,
Department of Empowerment of Persons with Disabilities,2018,12,142,115,27,0.809859155,,,
Department of Empowerment of Persons with Disabilities,2019,1,219,248,-29,1.132420091,,,
Department of Empowerment of Persons with Disabilities,2019,2,183,155,28,0.846994536,,,
Department of Empowerment of Persons with Disabilities,2019,3,198,121,77,0.611111111,,,
Department of Empowerment of Persons with Disabilities,2019,4,120,104,16,0.866666667,,,
Department of Empowerment of Persons with Disabilities,2019,5,170,311,-141,1.829411765,,,
Department of Empowerment of Persons with Disabilities,2019,6,211,197,14,0.933649289,,,
Department of Empowerment of Persons with Disabilities,2019,7,228,220,8,0.964912281,,,
Department of Empowerment of Persons with Disabilities,2019,8,196,255,-59,1.301020408,,,
Department of Empowerment of Persons with Disabilities,2019,9,258,184,74,0.713178295,,,
Department of Empowerment of Persons with Disabilities,2019,10,160,260,-100,1.625,,,
Department of Empowerment of Persons with Disabilities,2019,11,6,4,2,0.666666667,,,
Department of Ex Servicemen Welfare,2016,1,444,33,411,0.074324324,,,
Department of Ex Servicemen Welfare,2016,2,524,499,25,0.952290076,,,
Department of Ex Servicemen Welfare,2016,3,555,420,135,0.756756757,,,
Department of Ex Servicemen Welfare,2016,4,529,584,-55,1.103969754,,,
Department of Ex Servicemen Welfare,2016,5,555,552,3,0.994594595,,,
Department of Ex Servicemen Welfare,2016,6,696,567,129,0.814655172,,,
Department of Ex Servicemen Welfare,2016,7,617,492,125,0.797406807,,,
Department of Ex Servicemen Welfare,2016,8,478,605,-127,1.265690377,,,
Department of Ex Servicemen Welfare,2016,9,638,645,-7,1.010971787,,,
Department of Ex Servicemen Welfare,2016,10,586,423,163,0.721843003,,,
Department of Ex Servicemen Welfare,2016,11,738,333,405,0.451219512,,,
Department of Ex Servicemen Welfare,2016,12,522,532,-10,1.019157088,,,
Department of Ex Servicemen Welfare,2017,1,607,871,-264,1.434925865,,,
Department of Ex Servicemen Welfare,2017,2,638,772,-134,1.210031348,,,
Department of Ex Servicemen Welfare,2017,3,771,961,-190,1.246433204,,,
Department of Ex Servicemen Welfare,2017,4,673,505,168,0.750371471,,,
Department of Ex Servicemen Welfare,2017,5,742,659,83,0.888140162,,,
Department of Ex Servicemen Welfare,2017,6,799,621,178,0.777221527,,,
Department of Ex Servicemen Welfare,2017,7,681,987,-306,1.449339207,,,
Department of Ex Servicemen Welfare,2017,8,490,701,-211,1.430612245,,,
Department of Ex Servicemen Welfare,2017,9,395,607,-212,1.536708861,,,
Department of Ex Servicemen Welfare,2017,10,350,290,60,0.828571429,,,
Department of Ex Servicemen Welfare,2017,11,454,496,-42,1.092511013,,,
Department of Ex Servicemen Welfare,2017,12,375,349,26,0.930666667,,,
Department of Ex Servicemen Welfare,2018,1,384,388,-4,1.010416667,,,
Department of Ex Servicemen Welfare,2018,2,306,339,-33,1.107843137,,,
Department of Ex Servicemen Welfare,2018,3,427,191,236,0.447306792,,,
Department of Ex Servicemen Welfare,2018,4,332,564,-232,1.698795181,,,
Department of Ex Servicemen Welfare,2018,5,482,497,-15,1.031120332,,,
Department of Ex Servicemen Welfare,2018,6,349,294,55,0.842406877,,,
Department of Ex Servicemen Welfare,2018,7,518,485,33,0.936293436,,,
Department of Ex Servicemen Welfare,2018,8,578,507,71,0.87716263,,,
Department of Ex Servicemen Welfare,2018,9,442,483,-41,1.092760181,,,
Department of Ex Servicemen Welfare,2018,10,515,594,-79,1.153398058,,,
Department of Ex Servicemen Welfare,2018,11,418,408,10,0.976076555,,,
Department of Ex Servicemen Welfare,2018,12,428,435,-7,1.01635514,,,
Department of Ex Servicemen Welfare,2019,1,467,483,-16,1.034261242,,,
Department of Ex Servicemen Welfare,2019,2,521,487,34,0.934740883,,,
Department of Ex Servicemen Welfare,2019,3,498,372,126,0.746987952,,,
Department of Ex Servicemen Welfare,2019,4,543,659,-116,1.213627993,,,
Department of Ex Servicemen Welfare,2019,5,378,546,-168,1.444444444,,,
Department of Ex Servicemen Welfare,2019,6,587,425,162,0.724020443,,,
Department of Ex Servicemen Welfare,2019,7,605,602,3,0.995041322,,,
Department of Ex Servicemen Welfare,2019,8,557,618,-61,1.10951526,,,
Department of Ex Servicemen Welfare,2019,9,542,564,-22,1.040590406,,,
Department of Ex Servicemen Welfare,2019,10,546,564,-18,1.032967033,,,
Department of Ex Servicemen Welfare,2019,11,14,10,4,0.714285714,,,
Department of Expenditure,2016,1,197,34,163,0.172588832,,,
Department of Expenditure,2016,2,214,92,122,0.429906542,,,
Department of Expenditure,2016,3,172,118,54,0.686046512,,,
Department of Expenditure,2016,4,115,398,-283,3.460869565,,,
Department of Expenditure,2016,5,125,135,-10,1.08,,,
Department of Expenditure,2016,6,157,118,39,0.751592357,,,
Department of Expenditure,2016,7,305,346,-41,1.13442623,,,
Department of Expenditure,2016,8,208,101,107,0.485576923,,,
Department of Expenditure,2016,9,157,236,-79,1.503184713,,,
Department of Expenditure,2016,10,138,86,52,0.623188406,,,
Department of Expenditure,2016,11,162,176,-14,1.086419753,,,
Department of Expenditure,2016,12,119,145,-26,1.218487395,,,
Department of Expenditure,2017,1,106,107,-1,1.009433962,,,
Department of Expenditure,2017,2,288,99,189,0.34375,,,
Department of Expenditure,2017,3,256,353,-97,1.37890625,,,
Department of Expenditure,2017,4,568,210,358,0.36971831,,,
Department of Expenditure,2017,5,499,983,-484,1.96993988,,,
Department of Expenditure,2017,6,107,116,-9,1.08411215,,,
Department of Expenditure,2017,7,138,143,-5,1.036231884,,,
Department of Expenditure,2017,8,103,109,-6,1.058252427,,,
Department of Expenditure,2017,9,114,106,8,0.929824561,,,
Department of Expenditure,2017,10,421,443,-22,1.052256532,,,
Department of Expenditure,2017,11,230,224,6,0.973913043,,,
Department of Expenditure,2017,12,77,80,-3,1.038961039,,,
Department of Expenditure,2018,1,74,57,17,0.77027027,,,
Department of Expenditure,2018,2,51,60,-9,1.176470588,,,
Department of Expenditure,2018,3,91,74,17,0.813186813,,,
Department of Expenditure,2018,4,204,145,59,0.710784314,,,
Department of Expenditure,2018,5,246,280,-34,1.138211382,,,
Department of Expenditure,2018,6,124,141,-17,1.137096774,,,
Department of Expenditure,2018,7,114,97,17,0.850877193,,,
Department of Expenditure,2018,8,154,115,39,0.746753247,,,
Department of Expenditure,2018,9,203,195,8,0.960591133,,,
Department of Expenditure,2018,10,338,327,11,0.967455621,,,
Department of Expenditure,2018,11,1213,1178,35,0.971145919,,,
Department of Expenditure,2018,12,593,665,-72,1.121416526,,,
Department of Expenditure,2019,1,485,437,48,0.901030928,,,
Department of Expenditure,2019,2,710,714,-4,1.005633803,,,
Department of Expenditure,2019,3,355,395,-40,1.112676056,,,
Department of Expenditure,2019,4,463,526,-63,1.136069114,,,
Department of Expenditure,2019,5,193,177,16,0.917098446,,,
Department of Expenditure,2019,6,254,242,12,0.952755906,,,
Department of Expenditure,2019,7,602,592,10,0.983388704,,,
Department of Expenditure,2019,8,504,474,30,0.94047619,,,
Department of Expenditure,2019,9,346,304,42,0.878612717,,,
Department of Expenditure,2019,10,621,728,-107,1.172302738,,,
Department of Expenditure,2019,11,39,1,38,0.025641026,,,
Department of Fertilizers,2016,1,25,1,24,0.04,,,
Department of Fertilizers,2016,2,76,74,2,0.973684211,,,
Department of Fertilizers,2016,3,42,39,3,0.928571429,,,
Department of Fertilizers,2016,4,47,57,-10,1.212765957,,,
Department of Fertilizers,2016,5,41,36,5,0.87804878,,,
Department of Fertilizers,2016,6,50,13,37,0.26,,,
Department of Fertilizers,2016,7,36,30,6,0.833333333,,,
Department of Fertilizers,2016,8,47,15,32,0.319148936,,,
Department of Fertilizers,2016,9,37,38,-1,1.027027027,,,
Department of Fertilizers,2016,10,35,34,1,0.971428571,,,
Department of Fertilizers,2016,11,30,26,4,0.866666667,,,
Department of Fertilizers,2016,12,39,51,-12,1.307692308,,,
Department of Fertilizers,2017,1,34,30,4,0.882352941,,,
Department of Fertilizers,2017,2,44,38,6,0.863636364,,,
Department of Fertilizers,2017,3,45,77,-32,1.711111111,,,
Department of Fertilizers,2017,4,38,32,6,0.842105263,,,
Department of Fertilizers,2017,5,40,30,10,0.75,,,
Department of Fertilizers,2017,6,42,13,29,0.30952381,,,
Department of Fertilizers,2017,7,44,55,-11,1.25,,,
Department of Fertilizers,2017,8,40,9,31,0.225,,,
Department of Fertilizers,2017,9,24,8,16,0.333333333,,,
Department of Fertilizers,2017,11,40,73,-33,1.825,,,
Department of Fertilizers,2017,12,36,65,-29,1.805555556,,,
Department of Fertilizers,2018,1,32,31,1,0.96875,,,
Department of Fertilizers,2018,2,25,16,9,0.64,,,
Department of Fertilizers,2018,3,23,14,9,0.608695652,,,
Department of Fertilizers,2018,4,51,72,-21,1.411764706,,,
Department of Fertilizers,2018,5,74,109,-35,1.472972973,,,
Department of Fertilizers,2018,6,20,20,0,1,,,
Department of Fertilizers,2018,7,48,34,14,0.708333333,,,
Department of Fertilizers,2018,8,39,27,12,0.692307692,,,
Department of Fertilizers,2018,9,38,5,33,0.131578947,,,
Department of Fertilizers,2018,10,88,34,54,0.386363636,,,
Department of Fertilizers,2018,11,19,85,-66,4.473684211,,,
Department of Fertilizers,2018,12,52,124,-72,2.384615385,,,
Department of Fertilizers,2019,1,74,87,-13,1.175675676,,,
Department of Fertilizers,2019,2,47,55,-8,1.170212766,,,
Department of Fertilizers,2019,3,41,54,-13,1.317073171,,,
Department of Fertilizers,2019,4,27,26,1,0.962962963,,,
Department of Fertilizers,2019,5,22,18,4,0.818181818,,,
Department of Fertilizers,2019,6,54,30,24,0.555555556,,,
Department of Fertilizers,2019,7,36,34,2,0.944444444,,,
Department of Fertilizers,2019,8,40,27,13,0.675,,,
Department of Fertilizers,2019,9,42,49,-7,1.166666667,,,
Department of Fertilizers,2019,10,28,50,-22,1.785714286,,,
Department of Financial Services (Banking Division),2016,1,4397,1652,2745,0.375710712,,,
Department of Financial Services (Banking Division),2016,2,5873,3433,2440,0.584539418,,,
Department of Financial Services (Banking Division),2016,3,5296,5542,-246,1.046450151,,,
Department of Financial Services (Banking Division),2016,4,4697,4311,386,0.917819885,,,
Department of Financial Services (Banking Division),2016,5,8486,5164,3322,0.608531699,,,
Department of Financial Services (Banking Division),2016,6,7676,7577,99,0.987102658,,,
Department of Financial Services (Banking Division),2016,7,5064,7677,-2613,1.515995261,,,
Department of Financial Services (Banking Division),2016,8,6177,5719,458,0.925853974,,,
Department of Financial Services (Banking Division),2016,9,5410,6967,-1557,1.28780037,,,
Department of Financial Services (Banking Division),2016,10,4952,5698,-746,1.150646204,,,
Department of Financial Services (Banking Division),2016,11,10793,4906,5887,0.454553878,,,
Department of Financial Services (Banking Division),2016,12,19341,9178,10163,0.47453596,,,
Department of Financial Services (Banking Division),2017,1,12599,13314,-715,1.056750536,,,
Department of Financial Services (Banking Division),2017,2,9425,10088,-663,1.070344828,,,
Department of Financial Services (Banking Division),2017,3,11526,16093,-4567,1.3962346,,,
Department of Financial Services (Banking Division),2017,4,9447,10326,-879,1.093045411,,,
Department of Financial Services (Banking Division),2017,5,9425,11741,-2316,1.245729443,,,
Department of Financial Services (Banking Division),2017,6,10362,9222,1140,0.889982629,,,
Department of Financial Services (Banking Division),2017,7,8734,11381,-2647,1.303068468,,,
Department of Financial Services (Banking Division),2017,8,7016,9653,-2637,1.375855188,,,
Department of Financial Services (Banking Division),2017,9,6880,9189,-2309,1.335610465,,,
Department of Financial Services (Banking Division),2017,10,6336,6382,-46,1.007260101,,,
Department of Financial Services (Banking Division),2017,11,7319,6120,1199,0.836179806,,,
Department of Financial Services (Banking Division),2017,12,7214,7467,-253,1.035070696,,,
Department of Financial Services (Banking Division),2018,1,6567,8401,-1834,1.279275164,,,
Department of Financial Services (Banking Division),2018,2,6664,6115,549,0.917617047,,,
Department of Financial Services (Banking Division),2018,3,7738,6485,1253,0.838071853,,,
Department of Financial Services (Banking Division),2018,4,7833,7578,255,0.967445423,,,
Department of Financial Services (Banking Division),2018,5,9118,8310,808,0.911384075,,,
Department of Financial Services (Banking Division),2018,6,7191,7143,48,0.99332499,,,
Department of Financial Services (Banking Division),2018,7,9766,8136,1630,0.833094409,,,
Department of Financial Services (Banking Division),2018,8,10870,7296,3574,0.671205152,,,
Department of Financial Services (Banking Division),2018,9,9221,9159,62,0.993276217,,,
Department of Financial Services (Banking Division),2018,10,10670,12393,-1723,1.161480787,,,
Department of Financial Services (Banking Division),2018,11,8030,9114,-1084,1.134993773,,,
Department of Financial Services (Banking Division),2018,12,7720,8082,-362,1.046891192,,,
Department of Financial Services (Banking Division),2019,1,9142,8884,258,0.971778604,,,
Department of Financial Services (Banking Division),2019,2,8184,8064,120,0.985337243,,,
Department of Financial Services (Banking Division),2019,3,8107,8145,-38,1.004687307,,,
Department of Financial Services (Banking Division),2019,4,8165,8054,111,0.986405389,,,
Department of Financial Services (Banking Division),2019,5,8525,10819,-2294,1.269090909,,,
Department of Financial Services (Banking Division),2019,6,10118,8627,1491,0.852638861,,,
Department of Financial Services (Banking Division),2019,7,13517,12414,1103,0.918399053,,,
Department of Financial Services (Banking Division),2019,8,9047,10738,-1691,1.186912789,,,
Department of Financial Services (Banking Division),2019,9,10626,11415,-789,1.074251835,,,
Department of Financial Services (Banking Division),2019,10,9973,9506,467,0.953173569,,,
Department of Financial Services (Banking Division),2019,11,618,230,388,0.372168285,,,
Department of Financial Services (Insurance Division),2016,1,589,298,291,0.505942275,,,
Department of Financial Services (Insurance Division),2016,2,643,371,272,0.576982893,,,
Department of Financial Services (Insurance Division),2016,3,690,764,-74,1.107246377,,,
Department of Financial Services (Insurance Division),2016,4,740,495,245,0.668918919,,,
Department of Financial Services (Insurance Division),2016,5,767,787,-20,1.026075619,,,
Department of Financial Services (Insurance Division),2016,6,778,766,12,0.984575835,,,
Department of Financial Services (Insurance Division),2016,7,858,837,21,0.975524476,,,
Department of Financial Services (Insurance Division),2016,8,894,751,143,0.840044743,,,
Department of Financial Services (Insurance Division),2016,9,900,943,-43,1.047777778,,,
Department of Financial Services (Insurance Division),2016,10,895,1024,-129,1.144134078,,,
Department of Financial Services (Insurance Division),2016,11,916,1092,-176,1.192139738,,,
Department of Financial Services (Insurance Division),2016,12,1078,918,160,0.851576994,,,
Department of Financial Services (Insurance Division),2017,1,945,1033,-88,1.093121693,,,
Department of Financial Services (Insurance Division),2017,2,831,802,29,0.965102286,,,
Department of Financial Services (Insurance Division),2017,3,1033,1299,-266,1.25750242,,,
Department of Financial Services (Insurance Division),2017,4,942,799,143,0.848195329,,,
Department of Financial Services (Insurance Division),2017,5,1137,997,140,0.876868953,,,
Department of Financial Services (Insurance Division),2017,6,951,1039,-88,1.092534175,,,
Department of Financial Services (Insurance Division),2017,7,1039,1052,-13,1.012512031,,,
Department of Financial Services (Insurance Division),2017,8,990,1067,-77,1.077777778,,,
Department of Financial Services (Insurance Division),2017,9,920,853,67,0.927173913,,,
Department of Financial Services (Insurance Division),2017,10,864,856,8,0.990740741,,,
Department of Financial Services (Insurance Division),2017,11,946,998,-52,1.054968288,,,
Department of Financial Services (Insurance Division),2017,12,918,882,36,0.960784314,,,
Department of Financial Services (Insurance Division),2018,1,793,837,-44,1.055485498,,,
Department of Financial Services (Insurance Division),2018,2,743,700,43,0.942126514,,,
Department of Financial Services (Insurance Division),2018,3,922,1139,-217,1.235357918,,,
Department of Financial Services (Insurance Division),2018,4,1039,822,217,0.791145332,,,
Department of Financial Services (Insurance Division),2018,5,1020,967,53,0.948039216,,,
Department of Financial Services (Insurance Division),2018,6,853,860,-7,1.008206331,,,
Department of Financial Services (Insurance Division),2018,7,1096,984,112,0.897810219,,,
Department of Financial Services (Insurance Division),2018,8,1067,1055,12,0.988753515,,,
Department of Financial Services (Insurance Division),2018,9,1055,956,99,0.906161137,,,
Department of Financial Services (Insurance Division),2018,10,1044,1040,4,0.996168582,,,
Department of Financial Services (Insurance Division),2018,11,827,937,-110,1.133010883,,,
Department of Financial Services (Insurance Division),2018,12,891,940,-49,1.054994388,,,
Department of Financial Services (Insurance Division),2019,1,1039,1027,12,0.988450433,,,
Department of Financial Services (Insurance Division),2019,2,1016,943,73,0.928149606,,,
Department of Financial Services (Insurance Division),2019,3,1044,1480,-436,1.417624521,,,
Department of Financial Services (Insurance Division),2019,4,927,612,315,0.660194175,,,
Department of Financial Services (Insurance Division),2019,5,917,876,41,0.955288986,,,
Department of Financial Services (Insurance Division),2019,6,1093,1060,33,0.969807868,,,
Department of Financial Services (Insurance Division),2019,7,1395,1346,49,0.964874552,,,
Department of Financial Services (Insurance Division),2019,8,1213,1205,8,0.993404782,,,
Department of Financial Services (Insurance Division),2019,9,1296,1164,132,0.898148148,,,
Department of Financial Services (Insurance Division),2019,10,1134,1053,81,0.928571429,,,
Department of Financial Services (Insurance Division),2019,11,32,9,23,0.28125,,,
Department of Financial Services (Pension Reforms),2018,7,114,1,113,0.00877193,,,
Department of Financial Services (Pension Reforms),2018,8,135,141,-6,1.044444444,,,
Department of Financial Services (Pension Reforms),2018,9,111,83,28,0.747747748,,,
Department of Financial Services (Pension Reforms),2018,10,100,78,22,0.78,,,
Department of Financial Services (Pension Reforms),2018,11,93,168,-75,1.806451613,,,
Department of Financial Services (Pension Reforms),2018,12,136,186,-50,1.367647059,,,
Department of Financial Services (Pension Reforms),2019,1,173,144,29,0.832369942,,,
Department of Financial Services (Pension Reforms),2019,2,174,208,-34,1.195402299,,,
Department of Financial Services (Pension Reforms),2019,3,146,126,20,0.863013699,,,
Department of Financial Services (Pension Reforms),2019,4,108,129,-21,1.194444444,,,
Department of Financial Services (Pension Reforms),2019,5,129,110,19,0.852713178,,,
Department of Financial Services (Pension Reforms),2019,6,190,189,1,0.994736842,,,
Department of Financial Services (Pension Reforms),2019,7,167,162,5,0.97005988,,,
Department of Financial Services (Pension Reforms),2019,8,186,179,7,0.962365591,,,
Department of Financial Services (Pension Reforms),2019,9,186,205,-19,1.102150538,,,
Department of Financial Services (Pension Reforms),2019,10,153,138,15,0.901960784,,,
Department of Financial Services (Pension Reforms),2019,11,4,9,-5,2.25,,,
Department of Fisheries,2019,8,16,1,15,0.0625,,,
Department of Fisheries,2019,9,36,45,-9,1.25,,,
Department of Fisheries,2019,10,24,25,-1,1.041666667,,,
Department of Food and Public Distribution,2016,1,195,125,70,0.641025641,,,
Department of Food and Public Distribution,2016,2,257,206,51,0.80155642,,,
Department of Food and Public Distribution,2016,3,252,287,-35,1.138888889,,,
Department of Food and Public Distribution,2016,4,266,244,22,0.917293233,,,
Department of Food and Public Distribution,2016,5,310,285,25,0.919354839,,,
Department of Food and Public Distribution,2016,6,302,342,-40,1.132450331,,,
Department of Food and Public Distribution,2016,7,411,332,79,0.807785888,,,
Department of Food and Public Distribution,2016,8,384,377,7,0.981770833,,,
Department of Food and Public Distribution,2016,9,287,323,-36,1.12543554,,,
Department of Food and Public Distribution,2016,10,328,219,109,0.667682927,,,
Department of Food and Public Distribution,2016,11,231,350,-119,1.515151515,,,
Department of Food and Public Distribution,2016,12,364,307,57,0.843406593,,,
Department of Food and Public Distribution,2017,1,301,342,-41,1.136212625,,,
Department of Food and Public Distribution,2017,2,283,245,38,0.865724382,,,
Department of Food and Public Distribution,2017,3,364,346,18,0.950549451,,,
Department of Food and Public Distribution,2017,4,291,276,15,0.948453608,,,
Department of Food and Public Distribution,2017,5,349,380,-31,1.088825215,,,
Department of Food and Public Distribution,2017,6,336,372,-36,1.107142857,,,
Department of Food and Public Distribution,2017,7,341,312,29,0.914956012,,,
Department of Food and Public Distribution,2017,8,267,323,-56,1.209737828,,,
Department of Food and Public Distribution,2017,9,245,241,4,0.983673469,,,
Department of Food and Public Distribution,2017,10,249,207,42,0.831325301,,,
Department of Food and Public Distribution,2017,11,294,295,-1,1.003401361,,,
Department of Food and Public Distribution,2017,12,250,265,-15,1.06,,,
Department of Food and Public Distribution,2018,1,235,254,-19,1.080851064,,,
Department of Food and Public Distribution,2018,2,197,218,-21,1.106598985,,,
Department of Food and Public Distribution,2018,3,211,231,-20,1.09478673,,,
Department of Food and Public Distribution,2018,4,212,193,19,0.910377358,,,
Department of Food and Public Distribution,2018,5,306,290,16,0.947712418,,,
Department of Food and Public Distribution,2018,6,179,204,-25,1.139664804,,,
Department of Food and Public Distribution,2018,7,268,208,60,0.776119403,,,
Department of Food and Public Distribution,2018,8,277,267,10,0.963898917,,,
Department of Food and Public Distribution,2018,9,302,242,60,0.801324503,,,
Department of Food and Public Distribution,2018,10,310,358,-48,1.15483871,,,
Department of Food and Public Distribution,2018,11,382,370,12,0.968586387,,,
Department of Food and Public Distribution,2018,12,407,416,-9,1.022113022,,,
Department of Food and Public Distribution,2019,1,351,372,-21,1.05982906,,,
Department of Food and Public Distribution,2019,2,473,431,42,0.911205074,,,
Department of Food and Public Distribution,2019,3,555,572,-17,1.030630631,,,
Department of Food and Public Distribution,2019,4,271,334,-63,1.232472325,,,
Department of Food and Public Distribution,2019,5,263,296,-33,1.125475285,,,
Department of Food and Public Distribution,2019,6,366,325,41,0.887978142,,,
Department of Food and Public Distribution,2019,7,524,480,44,0.916030534,,,
Department of Food and Public Distribution,2019,8,450,469,-19,1.042222222,,,
Department of Food and Public Distribution,2019,9,426,425,1,0.997652582,,,
Department of Food and Public Distribution,2019,10,290,295,-5,1.017241379,,,
Department of Food and Public Distribution,2019,11,9,1,8,0.111111111,,,
Department of Health & Family Welfare,2016,1,1052,303,749,0.288022814,,,
Department of Health & Family Welfare,2016,2,1528,959,569,0.627617801,,,
Department of Health & Family Welfare,2016,3,1626,1489,137,0.915744157,,,
Department of Health & Family Welfare,2016,4,1450,946,504,0.652413793,,,
Department of Health & Family Welfare,2016,5,1891,2311,-420,1.222104707,,,
Department of Health & Family Welfare,2016,6,2167,1639,528,0.756345178,,,
Department of Health & Family Welfare,2016,7,1550,1940,-390,1.251612903,,,
Department of Health & Family Welfare,2016,8,1952,1347,605,0.690061475,,,
Department of Health & Family Welfare,2016,9,1883,1683,200,0.893786511,,,
Department of Health & Family Welfare,2016,10,1612,1672,-60,1.037220844,,,
Department of Health & Family Welfare,2016,11,1475,1641,-166,1.112542373,,,
Department of Health & Family Welfare,2016,12,2018,1620,398,0.802775025,,,
Department of Health & Family Welfare,2017,1,1664,2020,-356,1.213942308,,,
Department of Health & Family Welfare,2017,2,2688,2310,378,0.859375,,,
Department of Health & Family Welfare,2017,3,2489,3362,-873,1.35074327,,,
Department of Health & Family Welfare,2017,4,2285,1778,507,0.778118162,,,
Department of Health & Family Welfare,2017,5,2514,1893,621,0.752983294,,,
Department of Health & Family Welfare,2017,6,2056,2641,-585,1.284533074,,,
Department of Health & Family Welfare,2017,7,2012,2485,-473,1.235089463,,,
Department of Health & Family Welfare,2017,8,2404,1706,698,0.709650582,,,
Department of Health & Family Welfare,2017,9,1688,2387,-699,1.414099526,,,
Department of Health & Family Welfare,2017,10,1696,1585,111,0.934551887,,,
Department of Health & Family Welfare,2017,11,1559,1707,-148,1.094932649,,,
Department of Health & Family Welfare,2017,12,1233,1387,-154,1.124898621,,,
Department of Health & Family Welfare,2018,1,1327,1662,-335,1.252449133,,,
Department of Health & Family Welfare,2018,2,2685,1857,828,0.691620112,,,
Department of Health & Family Welfare,2018,3,1339,1646,-307,1.229275579,,,
Department of Health & Family Welfare,2018,4,1489,1446,43,0.971121558,,,
Department of Health & Family Welfare,2018,5,1957,1871,86,0.956055187,,,
Department of Health & Family Welfare,2018,6,1621,1094,527,0.674892042,,,
Department of Health & Family Welfare,2018,7,2410,2590,-180,1.074688797,,,
Department of Health & Family Welfare,2018,8,1853,1540,313,0.831084727,,,
Department of Health & Family Welfare,2018,9,1769,1734,35,0.980214811,,,
Department of Health & Family Welfare,2018,10,1680,1782,-102,1.060714286,,,
Department of Health & Family Welfare,2018,11,1238,1544,-306,1.247172859,,,
Department of Health & Family Welfare,2018,12,1224,1408,-184,1.150326797,,,
Department of Health & Family Welfare,2019,1,1485,1486,-1,1.000673401,,,
Department of Health & Family Welfare,2019,2,1494,1776,-282,1.18875502,,,
Department of Health & Family Welfare,2019,3,1636,1364,272,0.833740831,,,
Department of Health & Family Welfare,2019,4,1296,1392,-96,1.074074074,,,
Department of Health & Family Welfare,2019,5,1276,1552,-276,1.21630094,,,
Department of Health & Family Welfare,2019,6,2201,1486,715,0.67514766,,,
Department of Health & Family Welfare,2019,7,2090,3327,-1237,1.591866029,,,
Department of Health & Family Welfare,2019,8,1907,1902,5,0.997378081,,,
Department of Health & Family Welfare,2019,9,1820,1922,-102,1.056043956,,,
Department of Health & Family Welfare,2019,10,1595,1752,-157,1.098432602,,,
Department of Health & Family Welfare,2019,11,60,51,9,0.85,,,
Department of Health Research,2016,1,37,5,32,0.135135135,,,
Department of Health Research,2016,2,82,8,74,0.097560976,,,
Department of Health Research,2016,3,76,4,72,0.052631579,,,
Department of Health Research,2016,4,62,7,55,0.112903226,,,
Department of Health Research,2016,5,71,45,26,0.633802817,,,
Department of Health Research,2016,6,71,169,-98,2.38028169,,,
Department of Health Research,2016,7,71,62,9,0.873239437,,,
Department of Health Research,2016,8,67,85,-18,1.268656716,,,
Department of Health Research,2016,9,66,105,-39,1.590909091,,,
Department of Health Research,2016,10,58,75,-17,1.293103448,,,
Department of Health Research,2016,11,39,38,1,0.974358974,,,
Department of Health Research,2016,12,59,48,11,0.813559322,,,
Department of Health Research,2017,1,44,61,-17,1.386363636,,,
Department of Health Research,2017,2,82,69,13,0.841463415,,,
Department of Health Research,2017,3,125,120,5,0.96,,,
Department of Health Research,2017,4,52,60,-8,1.153846154,,,
Department of Health Research,2017,5,121,117,4,0.966942149,,,
Department of Health Research,2017,6,93,116,-23,1.247311828,,,
Department of Health Research,2017,7,150,104,46,0.693333333,,,
Department of Health Research,2017,8,103,105,-2,1.019417476,,,
Department of Health Research,2017,9,59,81,-22,1.372881356,,,
Department of Health Research,2017,10,71,76,-5,1.070422535,,,
Department of Health Research,2017,11,91,50,41,0.549450549,,,
Department of Health Research,2017,12,64,58,6,0.90625,,,
Department of Health Research,2018,1,47,36,11,0.765957447,,,
Department of Health Research,2018,2,40,62,-22,1.55,,,
Department of Health Research,2018,3,54,39,15,0.722222222,,,
Department of Health Research,2018,4,83,72,11,0.86746988,,,
Department of Health Research,2018,5,165,137,28,0.83030303,,,
Department of Health Research,2018,6,69,30,39,0.434782609,,,
Department of Health Research,2018,7,106,67,39,0.632075472,,,
Department of Health Research,2018,8,107,53,54,0.495327103,,,
Department of Health Research,2018,9,79,88,-9,1.113924051,,,
Department of Health Research,2018,10,67,76,-9,1.134328358,,,
Department of Health Research,2018,11,64,50,14,0.78125,,,
Department of Health Research,2018,12,81,110,-29,1.358024691,,,
Department of Health Research,2019,1,86,169,-83,1.965116279,,,
Department of Health Research,2019,2,58,75,-17,1.293103448,,,
Department of Health Research,2019,3,73,70,3,0.95890411,,,
Department of Health Research,2019,4,55,42,13,0.763636364,,,
Department of Health Research,2019,5,42,59,-17,1.404761905,,,
Department of Health Research,2019,6,46,47,-1,1.02173913,,,
Department of Health Research,2019,7,96,120,-24,1.25,,,
Department of Health Research,2019,8,68,61,7,0.897058824,,,
Department of Health Research,2019,9,99,78,21,0.787878788,,,
Department of Health Research,2019,10,69,81,-12,1.173913043,,,
Department of Health Research,2019,11,3,12,-9,4,,,
Department of Heavy Industry,2016,1,123,21,102,0.170731707,,,
Department of Heavy Industry,2016,2,178,106,72,0.595505618,,,
Department of Heavy Industry,2016,3,222,129,93,0.581081081,,,
Department of Heavy Industry,2016,4,119,263,-144,2.210084034,,,
Department of Heavy Industry,2016,5,123,139,-16,1.130081301,,,
Department of Heavy Industry,2016,6,140,114,26,0.814285714,,,
Department of Heavy Industry,2016,7,146,178,-32,1.219178082,,,
Department of Heavy Industry,2016,8,114,120,-6,1.052631579,,,
Department of Heavy Industry,2016,9,132,103,29,0.78030303,,,
Department of Heavy Industry,2016,10,126,109,17,0.865079365,,,
Department of Heavy Industry,2016,11,114,131,-17,1.149122807,,,
Department of Heavy Industry,2016,12,111,115,-4,1.036036036,,,
Department of Heavy Industry,2017,1,126,110,16,0.873015873,,,
Department of Heavy Industry,2017,2,130,100,30,0.769230769,,,
Department of Heavy Industry,2017,3,168,186,-18,1.107142857,,,
Department of Heavy Industry,2017,4,129,141,-12,1.093023256,,,
Department of Heavy Industry,2017,5,211,175,36,0.829383886,,,
Department of Heavy Industry,2017,6,156,158,-2,1.012820513,,,
Department of Heavy Industry,2017,7,137,181,-44,1.321167883,,,
Department of Heavy Industry,2017,8,174,144,30,0.827586207,,,
Department of Heavy Industry,2017,9,108,146,-38,1.351851852,,,
Department of Heavy Industry,2017,10,113,99,14,0.876106195,,,
Department of Heavy Industry,2017,11,155,160,-5,1.032258065,,,
Department of Heavy Industry,2017,12,114,113,1,0.99122807,,,
Department of Heavy Industry,2018,1,80,108,-28,1.35,,,
Department of Heavy Industry,2018,2,82,97,-15,1.182926829,,,
Department of Heavy Industry,2018,3,103,77,26,0.747572816,,,
Department of Heavy Industry,2018,4,132,135,-3,1.022727273,,,
Department of Heavy Industry,2018,5,186,168,18,0.903225806,,,
Department of Heavy Industry,2018,6,106,79,27,0.745283019,,,
Department of Heavy Industry,2018,7,133,202,-69,1.518796992,,,
Department of Heavy Industry,2018,8,122,109,13,0.893442623,,,
Department of Heavy Industry,2018,9,112,98,14,0.875,,,
Department of Heavy Industry,2018,10,115,123,-8,1.069565217,,,
Department of Heavy Industry,2018,11,94,114,-20,1.212765957,,,
Department of Heavy Industry,2018,12,104,120,-16,1.153846154,,,
Department of Heavy Industry,2019,1,99,118,-19,1.191919192,,,
Department of Heavy Industry,2019,2,111,102,9,0.918918919,,,
Department of Heavy Industry,2019,3,118,118,0,1,,,
Department of Heavy Industry,2019,4,106,121,-15,1.141509434,,,
Department of Heavy Industry,2019,5,88,76,12,0.863636364,,,
Department of Heavy Industry,2019,6,100,99,1,0.99,,,
Department of Heavy Industry,2019,7,121,103,18,0.851239669,,,
Department of Heavy Industry,2019,8,145,135,10,0.931034483,,,
Department of Heavy Industry,2019,9,151,159,-8,1.052980132,,,
Department of Heavy Industry,2019,10,120,137,-17,1.141666667,,,
Department of Heavy Industry,2019,11,7,20,-13,2.857142857,,,
Department of Higher Education,2016,1,1557,312,1245,0.200385356,,,
Department of Higher Education,2016,2,2127,1861,266,0.874941232,,,
Department of Higher Education,2016,3,2467,3166,-699,1.283340089,,,
Department of Higher Education,2016,4,2435,2075,360,0.852156057,,,
Department of Higher Education,2016,5,2396,2552,-156,1.065108514,,,
Department of Higher Education,2016,6,2555,2216,339,0.867318982,,,
Department of Higher Education,2016,7,2400,2530,-130,1.054166667,,,
Department of Higher Education,2016,8,2755,2377,378,0.862794918,,,
Department of Higher Education,2016,9,2245,2269,-24,1.010690423,,,
Department of Higher Education,2016,10,1847,1964,-117,1.063345966,,,
Department of Higher Education,2016,11,1609,1894,-285,1.177128651,,,
Department of Higher Education,2016,12,2140,1589,551,0.742523364,,,
Department of Higher Education,2017,1,1727,1997,-270,1.156340475,,,
Department of Higher Education,2017,2,1805,1750,55,0.969529086,,,
Department of Higher Education,2017,3,2763,2318,445,0.838943178,,,
Department of Higher Education,2017,4,2325,2490,-165,1.070967742,,,
Department of Higher Education,2017,5,2333,2149,184,0.92113159,,,
Department of Higher Education,2017,6,2384,2261,123,0.94840604,,,
Department of Higher Education,2017,7,2534,2860,-326,1.128650355,,,
Department of Higher Education,2017,8,2500,2812,-312,1.1248,,,
Department of Higher Education,2017,9,2363,1931,432,0.817181549,,,
Department of Higher Education,2017,10,1856,1822,34,0.981681034,,,
Department of Higher Education,2017,11,2064,1957,107,0.948158915,,,
Department of Higher Education,2017,12,1524,2021,-497,1.326115486,,,
Department of Higher Education,2018,1,1264,1487,-223,1.176424051,,,
Department of Higher Education,2018,2,1403,1347,56,0.960085531,,,
Department of Higher Education,2018,3,1561,1150,411,0.736707239,,,
Department of Higher Education,2018,4,1406,1211,195,0.861308677,,,
Department of Higher Education,2018,5,1958,1758,200,0.897854954,,,
Department of Higher Education,2018,6,1677,1017,660,0.606440072,,,
Department of Higher Education,2018,7,2149,2288,-139,1.064681247,,,
Department of Higher Education,2018,8,1941,2104,-163,1.083977331,,,
Department of Higher Education,2018,9,1527,2331,-804,1.526522593,,,
Department of Higher Education,2018,10,1975,1947,28,0.985822785,,,
Department of Higher Education,2018,11,1345,1896,-551,1.409665428,,,
Department of Higher Education,2018,12,1268,1254,14,0.988958991,,,
Department of Higher Education,2019,1,1371,1375,-4,1.002917578,,,
Department of Higher Education,2019,2,1466,1326,140,0.904502046,,,
Department of Higher Education,2019,3,1319,1188,131,0.900682335,,,
Department of Higher Education,2019,4,1227,1710,-483,1.393643032,,,
Department of Higher Education,2019,5,1471,1590,-119,1.080897349,,,
Department of Higher Education,2019,6,2014,1131,883,0.561569017,,,
Department of Higher Education,2019,7,2369,1788,581,0.754748839,,,
Department of Higher Education,2019,8,2085,2480,-395,1.189448441,,,
Department of Higher Education,2019,9,2077,2152,-75,1.036109774,,,
Department of Higher Education,2019,10,1669,1614,55,0.967046135,,,
Department of Higher Education,2019,11,43,34,9,0.790697674,,,
Department of Industrial Policy & Promotion,2016,1,295,133,162,0.450847458,,,
Department of Industrial Policy & Promotion,2016,2,243,190,53,0.781893004,,,
Department of Industrial Policy & Promotion,2016,3,197,158,39,0.802030457,,,
Department of Industrial Policy & Promotion,2016,4,191,153,38,0.80104712,,,
Department of Industrial Policy & Promotion,2016,5,155,263,-108,1.696774194,,,
Department of Industrial Policy & Promotion,2016,6,178,326,-148,1.831460674,,,
Department of Industrial Policy & Promotion,2016,7,154,132,22,0.857142857,,,
Department of Industrial Policy & Promotion,2016,8,151,142,9,0.940397351,,,
Department of Industrial Policy & Promotion,2016,9,222,192,30,0.864864865,,,
Department of Industrial Policy & Promotion,2016,10,216,220,-4,1.018518519,,,
Department of Industrial Policy & Promotion,2016,11,112,137,-25,1.223214286,,,
Department of Industrial Policy & Promotion,2016,12,156,138,18,0.884615385,,,
Department of Industrial Policy & Promotion,2017,1,144,141,3,0.979166667,,,
Department of Industrial Policy & Promotion,2017,2,154,173,-19,1.123376623,,,
Department of Industrial Policy & Promotion,2017,3,238,228,10,0.957983193,,,
Department of Industrial Policy & Promotion,2017,4,174,189,-15,1.086206897,,,
Department of Industrial Policy & Promotion,2017,5,229,209,20,0.912663755,,,
Department of Industrial Policy & Promotion,2017,6,232,243,-11,1.047413793,,,
Department of Industrial Policy & Promotion,2017,7,280,287,-7,1.025,,,
Department of Industrial Policy & Promotion,2017,8,181,206,-25,1.138121547,,,
Department of Industrial Policy & Promotion,2017,9,172,168,4,0.976744186,,,
Department of Industrial Policy & Promotion,2017,10,168,149,19,0.886904762,,,
Department of Industrial Policy & Promotion,2017,11,199,219,-20,1.100502513,,,
Department of Industrial Policy & Promotion,2017,12,131,135,-4,1.030534351,,,
Department of Industrial Policy & Promotion,2018,1,111,105,6,0.945945946,,,
Department of Industrial Policy & Promotion,2018,2,249,229,20,0.919678715,,,
Department of Industrial Policy & Promotion,2018,3,117,135,-18,1.153846154,,,
Department of Industrial Policy & Promotion,2018,4,132,125,7,0.946969697,,,
Department of Industrial Policy & Promotion,2018,5,183,189,-6,1.032786885,,,
Department of Industrial Policy & Promotion,2018,6,127,119,8,0.937007874,,,
Department of Industrial Policy & Promotion,2018,7,168,148,20,0.880952381,,,
Department of Industrial Policy & Promotion,2018,8,218,208,10,0.95412844,,,
Department of Industrial Policy & Promotion,2018,9,115,131,-16,1.139130435,,,
Department of Industrial Policy & Promotion,2018,10,152,137,15,0.901315789,,,
Department of Industrial Policy & Promotion,2018,11,99,120,-21,1.212121212,,,
Department of Industrial Policy & Promotion,2018,12,148,139,9,0.939189189,,,
Department of Industrial Policy & Promotion,2019,1,173,194,-21,1.121387283,,,
Department of Industrial Policy & Promotion,2019,2,167,158,9,0.946107784,,,
Department of Industrial Policy & Promotion,2019,3,198,185,13,0.934343434,,,
Department of Industrial Policy & Promotion,2019,4,136,159,-23,1.169117647,,,
Department of Industrial Policy & Promotion,2019,5,148,147,1,0.993243243,,,
Department of Industrial Policy & Promotion,2019,6,132,144,-12,1.090909091,,,
Department of Industrial Policy & Promotion,2019,7,181,184,-3,1.016574586,,,
Department of Industrial Policy & Promotion,2019,8,147,144,3,0.979591837,,,
Department of Industrial Policy & Promotion,2019,9,185,185,0,1,,,
Department of Industrial Policy & Promotion,2019,10,155,158,-3,1.019354839,,,
Department of Industrial Policy & Promotion,2019,11,4,7,-3,1.75,,,
Department of Investment & Public Asset Management,2016,1,15,10,5,0.666666667,,,
Department of Investment & Public Asset Management,2016,2,18,9,9,0.5,,,
Department of Investment & Public Asset Management,2016,3,36,27,9,0.75,,,
Department of Investment & Public Asset Management,2016,4,26,37,-11,1.423076923,,,
Department of Investment & Public Asset Management,2016,5,31,33,-2,1.064516129,,,
Department of Investment & Public Asset Management,2016,6,21,17,4,0.80952381,,,
Department of Investment & Public Asset Management,2016,7,19,1,18,0.052631579,,,
Department of Investment & Public Asset Management,2016,8,11,31,-20,2.818181818,,,
Department of Investment & Public Asset Management,2016,9,57,64,-7,1.122807018,,,
Department of Investment & Public Asset Management,2016,10,26,22,4,0.846153846,,,
Department of Investment & Public Asset Management,2016,11,41,37,4,0.902439024,,,
Department of Investment & Public Asset Management,2016,12,29,34,-5,1.172413793,,,
Department of Investment & Public Asset Management,2017,1,28,21,7,0.75,,,
Department of Investment & Public Asset Management,2017,2,27,27,0,1,,,
Department of Investment & Public Asset Management,2017,3,37,39,-2,1.054054054,,,
Department of Investment & Public Asset Management,2017,4,32,19,13,0.59375,,,
Department of Investment & Public Asset Management,2017,5,35,38,-3,1.085714286,,,
Department of Investment & Public Asset Management,2017,6,31,40,-9,1.290322581,,,
Department of Investment & Public Asset Management,2017,7,68,69,-1,1.014705882,,,
Department of Investment & Public Asset Management,2017,8,31,32,-1,1.032258065,,,
Department of Investment & Public Asset Management,2017,9,31,31,0,1,,,
Department of Investment & Public Asset Management,2017,10,32,37,-5,1.15625,,,
Department of Investment & Public Asset Management,2017,11,69,73,-4,1.057971014,,,
Department of Investment & Public Asset Management,2017,12,37,34,3,0.918918919,,,
Department of Investment & Public Asset Management,2018,1,38,26,12,0.684210526,,,
Department of Investment & Public Asset Management,2018,2,25,39,-14,1.56,,,
Department of Investment & Public Asset Management,2018,3,36,28,8,0.777777778,,,
Department of Investment & Public Asset Management,2018,4,58,50,8,0.862068966,,,
Department of Investment & Public Asset Management,2018,5,87,99,-12,1.137931034,,,
Department of Investment & Public Asset Management,2018,6,28,29,-1,1.035714286,,,
Department of Investment & Public Asset Management,2018,7,31,30,1,0.967741935,,,
Department of Investment & Public Asset Management,2018,8,22,29,-7,1.318181818,,,
Department of Investment & Public Asset Management,2018,9,25,23,2,0.92,,,
Department of Investment & Public Asset Management,2018,10,24,26,-2,1.083333333,,,
Department of Investment & Public Asset Management,2018,11,19,19,0,1,,,
Department of Investment & Public Asset Management,2018,12,37,35,2,0.945945946,,,
Department of Investment & Public Asset Management,2019,1,51,46,5,0.901960784,,,
Department of Investment & Public Asset Management,2019,2,46,45,1,0.97826087,,,
Department of Investment & Public Asset Management,2019,3,62,62,0,1,,,
Department of Investment & Public Asset Management,2019,4,37,39,-2,1.054054054,,,
Department of Investment & Public Asset Management,2019,5,43,38,5,0.88372093,,,
Department of Investment & Public Asset Management,2019,6,50,34,16,0.68,,,
Department of Investment & Public Asset Management,2019,7,48,53,-5,1.104166667,,,
Department of Investment & Public Asset Management,2019,8,49,42,7,0.857142857,,,
Department of Investment & Public Asset Management,2019,9,50,64,-14,1.28,,,
Department of Investment & Public Asset Management,2019,10,41,50,-9,1.219512195,,,
Department of Investment & Public Asset Management,2019,11,2,2,0,1,,,
Department of Justice,2016,1,1239,679,560,0.548022599,,,
Department of Justice,2016,2,1260,975,285,0.773809524,,,
Department of Justice,2016,3,965,1331,-366,1.379274611,,,
Department of Justice,2016,4,670,925,-255,1.380597015,,,
Department of Justice,2016,5,588,714,-126,1.214285714,,,
Department of Justice,2016,6,642,543,99,0.845794393,,,
Department of Justice,2016,7,544,452,92,0.830882353,,,
Department of Justice,2016,8,753,593,160,0.7875166,,,
Department of Justice,2016,9,739,584,155,0.790257104,,,
Department of Justice,2016,10,640,921,-281,1.4390625,,,
Department of Justice,2016,11,647,800,-153,1.236476043,,,
Department of Justice,2016,12,906,686,220,0.757174393,,,
Department of Justice,2017,1,834,1025,-191,1.229016787,,,
Department of Justice,2017,2,554,584,-30,1.054151625,,,
Department of Justice,2017,3,1100,1160,-60,1.054545455,,,
Department of Justice,2017,4,979,938,41,0.958120531,,,
Department of Justice,2017,5,1065,1082,-17,1.015962441,,,
Department of Justice,2017,6,897,974,-77,1.085841695,,,
Department of Justice,2017,7,1169,1125,44,0.962360992,,,
Department of Justice,2017,8,1182,1250,-68,1.057529611,,,
Department of Justice,2017,9,1037,929,108,0.895853423,,,
Department of Justice,2017,10,613,525,88,0.856443719,,,
Department of Justice,2017,11,679,610,69,0.898379971,,,
Department of Justice,2017,12,564,753,-189,1.335106383,,,
Department of Justice,2018,1,578,616,-38,1.065743945,,,
Department of Justice,2018,2,535,446,89,0.83364486,,,
Department of Justice,2018,3,671,440,231,0.655737705,,,
Department of Justice,2018,4,669,661,8,0.988041854,,,
Department of Justice,2018,5,858,867,-9,1.01048951,,,
Department of Justice,2018,6,486,555,-69,1.141975309,,,
Department of Justice,2018,7,618,523,95,0.846278317,,,
Department of Justice,2018,8,697,348,349,0.49928264,,,
Department of Justice,2018,9,629,840,-211,1.3354531,,,
Department of Justice,2018,10,748,929,-181,1.24197861,,,
Department of Justice,2018,11,591,576,15,0.974619289,,,
Department of Justice,2018,12,494,293,201,0.593117409,,,
Department of Justice,2019,1,561,643,-82,1.146167558,,,
Department of Justice,2019,2,620,974,-354,1.570967742,,,
Department of Justice,2019,3,563,601,-38,1.06749556,,,
Department of Justice,2019,4,593,626,-33,1.055649241,,,
Department of Justice,2019,5,620,632,-12,1.019354839,,,
Department of Justice,2019,6,667,602,65,0.902548726,,,
Department of Justice,2019,7,917,933,-16,1.017448201,,,
Department of Justice,2019,8,808,877,-69,1.08539604,,,
Department of Justice,2019,9,1069,995,74,0.930776427,,,
Department of Justice,2019,10,767,678,89,0.883963494,,,
Department of Justice,2019,11,20,11,9,0.55,,,
Department of Land Resources,2016,1,48,3,45,0.0625,,,
Department of Land Resources,2016,2,44,40,4,0.909090909,,,
Department of Land Resources,2016,3,77,116,-39,1.506493506,,,
Department of Land Resources,2016,4,42,52,-10,1.238095238,,,
Department of Land Resources,2016,5,39,41,-2,1.051282051,,,
Department of Land Resources,2016,6,65,70,-5,1.076923077,,,
Department of Land Resources,2016,7,42,2,40,0.047619048,,,
Department of Land Resources,2016,8,69,21,48,0.304347826,,,
Department of Land Resources,2016,9,39,2,37,0.051282051,,,
Department of Land Resources,2016,10,35,76,-41,2.171428571,,,
Department of Land Resources,2016,11,79,118,-39,1.493670886,,,
Department of Land Resources,2016,12,104,64,40,0.615384615,,,
Department of Land Resources,2017,1,47,64,-17,1.361702128,,,
Department of Land Resources,2017,2,97,7,90,0.072164948,,,
Department of Land Resources,2017,3,71,76,-5,1.070422535,,,
Department of Land Resources,2017,4,82,50,32,0.609756098,,,
Department of Land Resources,2017,5,82,207,-125,2.524390244,,,
Department of Land Resources,2017,6,92,96,-4,1.043478261,,,
Department of Land Resources,2017,7,82,84,-2,1.024390244,,,
Department of Land Resources,2017,8,78,90,-12,1.153846154,,,
Department of Land Resources,2017,9,72,90,-18,1.25,,,
Department of Land Resources,2017,10,65,18,47,0.276923077,,,
Department of Land Resources,2017,11,68,119,-51,1.75,,,
Department of Land Resources,2017,12,64,67,-3,1.046875,,,
Department of Land Resources,2018,1,39,53,-14,1.358974359,,,
Department of Land Resources,2018,2,38,15,23,0.394736842,,,
Department of Land Resources,2018,3,41,4,37,0.097560976,,,
Department of Land Resources,2018,4,49,10,39,0.204081633,,,
Department of Land Resources,2018,5,101,175,-74,1.732673267,,,
Department of Land Resources,2018,6,31,31,0,1,,,
Department of Land Resources,2018,7,45,56,-11,1.244444444,,,
Department of Land Resources,2018,8,50,63,-13,1.26,,,
Department of Land Resources,2018,9,36,37,-1,1.027777778,,,
Department of Land Resources,2018,10,42,36,6,0.857142857,,,
Department of Land Resources,2018,11,42,45,-3,1.071428571,,,
Department of Land Resources,2018,12,55,38,17,0.690909091,,,
Department of Land Resources,2019,1,61,70,-9,1.147540984,,,
Department of Land Resources,2019,2,66,65,1,0.984848485,,,
Department of Land Resources,2019,3,80,75,5,0.9375,,,
Department of Land Resources,2019,4,30,6,24,0.2,,,
Department of Land Resources,2019,5,43,1,42,0.023255814,,,
Department of Land Resources,2019,6,64,79,-15,1.234375,,,
Department of Land Resources,2019,7,81,49,32,0.604938272,,,
Department of Land Resources,2019,8,61,28,33,0.459016393,,,
Department of Land Resources,2019,9,81,101,-20,1.24691358,,,
Department of Land Resources,2019,10,43,13,30,0.302325581,,,
Department of Land Resources,2019,11,3,10,-7,3.333333333,,,
Department of Legal Affairs,2016,1,379,273,106,0.720316623,,,
Department of Legal Affairs,2016,2,396,254,142,0.641414141,,,
Department of Legal Affairs,2016,3,264,277,-13,1.049242424,,,
Department of Legal Affairs,2016,4,200,173,27,0.865,,,
Department of Legal Affairs,2016,5,180,144,36,0.8,,,
Department of Legal Affairs,2016,6,201,29,172,0.144278607,,,
Department of Legal Affairs,2016,7,175,249,-74,1.422857143,,,
Department of Legal Affairs,2016,8,269,80,189,0.29739777,,,
Department of Legal Affairs,2016,9,250,127,123,0.508,,,
Department of Legal Affairs,2016,10,233,141,92,0.605150215,,,
Department of Legal Affairs,2016,11,267,242,25,0.906367041,,,
Department of Legal Affairs,2016,12,321,193,128,0.601246106,,,
Department of Legal Affairs,2017,1,265,120,145,0.452830189,,,
Department of Legal Affairs,2017,2,233,281,-48,1.206008584,,,
Department of Legal Affairs,2017,3,449,299,150,0.665924276,,,
Department of Legal Affairs,2017,4,341,151,190,0.442815249,,,
Department of Legal Affairs,2017,5,410,592,-182,1.443902439,,,
Department of Legal Affairs,2017,6,347,534,-187,1.538904899,,,
Department of Legal Affairs,2017,7,304,327,-23,1.075657895,,,
Department of Legal Affairs,2017,8,335,289,46,0.862686567,,,
Department of Legal Affairs,2017,9,249,179,70,0.718875502,,,
Department of Legal Affairs,2017,10,222,179,43,0.806306306,,,
Department of Legal Affairs,2017,11,240,218,22,0.908333333,,,
Department of Legal Affairs,2017,12,224,89,135,0.397321429,,,
Department of Legal Affairs,2018,1,200,174,26,0.87,,,
Department of Legal Affairs,2018,2,176,137,39,0.778409091,,,
Department of Legal Affairs,2018,3,238,114,124,0.478991597,,,
Department of Legal Affairs,2018,4,264,327,-63,1.238636364,,,
Department of Legal Affairs,2018,5,272,239,33,0.878676471,,,
Department of Legal Affairs,2018,6,158,91,67,0.575949367,,,
Department of Legal Affairs,2018,7,236,118,118,0.5,,,
Department of Legal Affairs,2018,8,213,170,43,0.798122066,,,
Department of Legal Affairs,2018,9,181,145,36,0.801104972,,,
Department of Legal Affairs,2018,10,224,84,140,0.375,,,
Department of Legal Affairs,2018,11,225,96,129,0.426666667,,,
Department of Legal Affairs,2018,12,198,288,-90,1.454545455,,,
Department of Legal Affairs,2019,1,233,90,143,0.386266094,,,
Department of Legal Affairs,2019,2,311,218,93,0.70096463,,,
Department of Legal Affairs,2019,3,349,226,123,0.64756447,,,
Department of Legal Affairs,2019,4,183,105,78,0.573770492,,,
Department of Legal Affairs,2019,5,169,93,76,0.550295858,,,
Department of Legal Affairs,2019,6,211,140,71,0.663507109,,,
Department of Legal Affairs,2019,7,241,182,59,0.755186722,,,
Department of Legal Affairs,2019,8,318,129,189,0.405660377,,,
Department of Legal Affairs,2019,9,293,135,158,0.460750853,,,
Department of Legal Affairs,2019,10,304,447,-143,1.470394737,,,
Department of Official Language,2016,1,12,5,7,0.416666667,,,
Department of Official Language,2016,2,26,22,4,0.846153846,,,
Department of Official Language,2016,3,25,32,-7,1.28,,,
Department of Official Language,2016,4,14,10,4,0.714285714,,,
Department of Official Language,2016,5,31,34,-3,1.096774194,,,
Department of Official Language,2016,6,28,32,-4,1.142857143,,,
Department of Official Language,2016,7,29,20,9,0.689655172,,,
Department of Official Language,2016,8,35,39,-4,1.114285714,,,
Department of Official Language,2016,9,59,60,-1,1.016949153,,,
Department of Official Language,2016,10,27,22,5,0.814814815,,,
Department of Official Language,2016,11,26,24,2,0.923076923,,,
Department of Official Language,2016,12,20,17,3,0.85,,,
Department of Official Language,2017,1,17,27,-10,1.588235294,,,
Department of Official Language,2017,2,20,17,3,0.85,,,
Department of Official Language,2017,3,31,25,6,0.806451613,,,
Department of Official Language,2017,4,31,27,4,0.870967742,,,
Department of Official Language,2017,5,27,33,-6,1.222222222,,,
Department of Official Language,2017,6,27,35,-8,1.296296296,,,
Department of Official Language,2017,7,20,19,1,0.95,,,
Department of Official Language,2017,8,25,23,2,0.92,,,
Department of Official Language,2017,9,27,20,7,0.740740741,,,
Department of Official Language,2017,10,11,18,-7,1.636363636,,,
Department of Official Language,2017,11,32,25,7,0.78125,,,
Department of Official Language,2017,12,28,20,8,0.714285714,,,
Department of Official Language,2018,1,22,27,-5,1.227272727,,,
Department of Official Language,2018,2,24,35,-11,1.458333333,,,
Department of Official Language,2018,3,30,22,8,0.733333333,,,
Department of Official Language,2018,4,44,26,18,0.590909091,,,
Department of Official Language,2018,5,69,69,0,1,,,
Department of Official Language,2018,6,12,35,-23,2.916666667,,,
Department of Official Language,2018,7,34,29,5,0.852941176,,,
Department of Official Language,2018,8,53,31,22,0.58490566,,,
Department of Official Language,2018,9,35,45,-10,1.285714286,,,
Department of Official Language,2018,10,27,27,0,1,,,
Department of Official Language,2018,11,11,26,-15,2.363636364,,,
Department of Official Language,2018,12,33,26,7,0.787878788,,,
Department of Official Language,2019,1,39,41,-2,1.051282051,,,
Department of Official Language,2019,2,50,35,15,0.7,,,
Department of Official Language,2019,3,45,25,20,0.555555556,,,
Department of Official Language,2019,4,15,60,-45,4,,,
Department of Official Language,2019,5,10,6,4,0.6,,,
Department of Official Language,2019,6,26,19,7,0.730769231,,,
Department of Official Language,2019,7,26,27,-1,1.038461538,,,
Department of Official Language,2019,8,20,20,0,1,,,
Department of Official Language,2019,9,47,29,18,0.617021277,,,
Department of Official Language,2019,10,38,59,-21,1.552631579,,,
Department of Official Language,2019,11,1,1,0,1,,,
Department of Personnel and Training,2016,1,915,291,624,0.318032787,,,
Department of Personnel and Training,2016,2,13746,13001,745,0.945802415,,,
Department of Personnel and Training,2016,3,2794,2074,720,0.742304939,,,
Department of Personnel and Training,2016,4,1431,919,512,0.642208246,,,
Department of Personnel and Training,2016,5,1166,2834,-1668,2.430531732,,,
Department of Personnel and Training,2016,6,1636,1158,478,0.707823961,,,
Department of Personnel and Training,2016,7,967,1514,-547,1.565667011,,,
Department of Personnel and Training,2016,8,1362,1141,221,0.83773862,,,
Department of Personnel and Training,2016,9,2619,1957,662,0.747231768,,,
Department of Personnel and Training,2016,10,1760,2217,-457,1.259659091,,,
Department of Personnel and Training,2016,11,1801,1918,-117,1.064963909,,,
Department of Personnel and Training,2016,12,6313,1384,4929,0.21923016,,,
Department of Personnel and Training,2017,1,5057,8558,-3501,1.692307692,,,
Department of Personnel and Training,2017,2,1467,2568,-1101,1.750511247,,,
Department of Personnel and Training,2017,3,2206,2324,-118,1.053490481,,,
Department of Personnel and Training,2017,4,2125,2336,-211,1.099294118,,,
Department of Personnel and Training,2017,5,4603,1674,2929,0.363675864,,,
Department of Personnel and Training,2017,6,1866,3717,-1851,1.991961415,,,
Department of Personnel and Training,2017,7,2065,3032,-967,1.468280872,,,
Department of Personnel and Training,2017,8,4032,3061,971,0.759176587,,,
Department of Personnel and Training,2017,9,2206,2829,-623,1.282411605,,,
Department of Personnel and Training,2017,10,1475,1601,-126,1.085423729,,,
Department of Personnel and Training,2017,11,3956,2446,1510,0.618301314,,,
Department of Personnel and Training,2017,12,1827,3558,-1731,1.947454844,,,
Department of Personnel and Training,2018,1,1880,1039,841,0.552659574,,,
Department of Personnel and Training,2018,2,919,1505,-586,1.637649619,,,
Department of Personnel and Training,2018,3,3292,1855,1437,0.563487242,,,
Department of Personnel and Training,2018,4,1140,2695,-1555,2.364035088,,,
Department of Personnel and Training,2018,5,2757,1002,1755,0.36343852,,,
Department of Personnel and Training,2018,6,1753,2690,-937,1.534512265,,,
Department of Personnel and Training,2018,7,1049,1567,-518,1.493803622,,,
Department of Personnel and Training,2018,8,1387,1604,-217,1.156452776,,,
Department of Personnel and Training,2018,9,1277,1363,-86,1.067345341,,,
Department of Personnel and Training,2018,10,1322,1427,-105,1.079425113,,,
Department of Personnel and Training,2018,11,838,944,-106,1.126491647,,,
Department of Personnel and Training,2018,12,908,889,19,0.97907489,,,
Department of Personnel and Training,2019,1,857,674,183,0.786464411,,,
Department of Personnel and Training,2019,2,1245,1185,60,0.951807229,,,
Department of Personnel and Training,2019,3,1035,1031,4,0.996135266,,,
Department of Personnel and Training,2019,4,834,853,-19,1.022781775,,,
Department of Personnel and Training,2019,5,981,978,3,0.996941896,,,
Department of Personnel and Training,2019,6,1400,1349,51,0.963571429,,,
Department of Personnel and Training,2019,7,1230,1589,-359,1.291869919,,,
Department of Personnel and Training,2019,8,1108,958,150,0.864620939,,,
Department of Personnel and Training,2019,9,1346,1263,83,0.93833581,,,
Department of Personnel and Training,2019,10,1226,1346,-120,1.097879282,,,
Department of Personnel and Training,2019,11,26,148,-122,5.692307692,,,
Department of Pharmaceutical,2016,2,304,1,303,0.003289474,,,
Department of Pharmaceutical,2016,4,65,337,-272,5.184615385,,,
Department of Pharmaceutical,2016,5,72,164,-92,2.277777778,,,
Department of Pharmaceutical,2016,6,107,105,2,0.981308411,,,
Department of Pharmaceutical,2016,7,95,182,-87,1.915789474,,,
Department of Pharmaceutical,2016,8,114,75,39,0.657894737,,,
Department of Pharmaceutical,2016,9,95,73,22,0.768421053,,,
Department of Pharmaceutical,2016,10,105,41,64,0.39047619,,,
Department of Pharmaceutical,2016,11,104,4,100,0.038461538,,,
Department of Pharmaceutical,2016,12,150,54,96,0.36,,,
Department of Pharmaceutical,2017,1,169,245,-76,1.449704142,,,
Department of Pharmaceutical,2017,2,144,38,106,0.263888889,,,
Department of Pharmaceutical,2017,3,155,32,123,0.206451613,,,
Department of Pharmaceutical,2017,4,177,235,-58,1.327683616,,,
Department of Pharmaceutical,2017,5,218,246,-28,1.128440367,,,
Department of Pharmaceutical,2017,6,171,153,18,0.894736842,,,
Department of Pharmaceutical,2017,7,195,115,80,0.58974359,,,
Department of Pharmaceutical,2017,8,142,123,19,0.866197183,,,
Department of Pharmaceutical,2017,9,115,314,-199,2.730434783,,,
Department of Pharmaceutical,2017,10,101,301,-200,2.98019802,,,
Department of Pharmaceutical,2017,11,143,186,-43,1.300699301,,,
Department of Pharmaceutical,2017,12,101,101,0,1,,,
Department of Pharmaceutical,2018,1,92,86,6,0.934782609,,,
Department of Pharmaceutical,2018,2,121,91,30,0.752066116,,,
Department of Pharmaceutical,2018,3,95,118,-23,1.242105263,,,
Department of Pharmaceutical,2018,4,110,96,14,0.872727273,,,
Department of Pharmaceutical,2018,5,181,145,36,0.801104972,,,
Department of Pharmaceutical,2018,6,98,117,-19,1.193877551,,,
Department of Pharmaceutical,2018,7,169,156,13,0.923076923,,,
Department of Pharmaceutical,2018,8,179,159,20,0.888268156,,,
Department of Pharmaceutical,2018,9,151,197,-46,1.304635762,,,
Department of Pharmaceutical,2018,10,170,192,-22,1.129411765,,,
Department of Pharmaceutical,2018,11,571,562,9,0.984238179,,,
Department of Pharmaceutical,2018,12,219,93,126,0.424657534,,,
Department of Pharmaceutical,2019,1,151,301,-150,1.993377483,,,
Department of Pharmaceutical,2019,2,301,151,150,0.50166113,,,
Department of Pharmaceutical,2019,3,133,299,-166,2.248120301,,,
Department of Pharmaceutical,2019,4,90,104,-14,1.155555556,,,
Department of Pharmaceutical,2019,5,74,65,9,0.878378378,,,
Department of Pharmaceutical,2019,6,105,103,2,0.980952381,,,
Department of Pharmaceutical,2019,7,146,158,-12,1.082191781,,,
Department of Pharmaceutical,2019,8,122,119,3,0.975409836,,,
Department of Pharmaceutical,2019,9,112,104,8,0.928571429,,,
Department of Pharmaceutical,2019,10,100,119,-19,1.19,,,
Department of Pharmaceutical,2019,11,4,1,3,0.25,,,
Department of Posts,2016,1,1585,814,771,0.513564669,,,
Department of Posts,2016,2,1717,1702,15,0.991263832,,,
Department of Posts,2016,3,1942,1794,148,0.923789907,,,
Department of Posts,2016,4,2028,1907,121,0.940335306,,,
Department of Posts,2016,5,2180,2086,94,0.956880734,,,
Department of Posts,2016,6,2166,2091,75,0.965373961,,,
Department of Posts,2016,7,2054,2042,12,0.994157741,,,
Department of Posts,2016,8,3021,2633,388,0.871565707,,,
Department of Posts,2016,9,2844,3159,-315,1.110759494,,,
Department of Posts,2016,10,3267,2639,628,0.807774717,,,
Department of Posts,2016,11,3156,3248,-92,1.029150824,,,
Department of Posts,2016,12,3307,3570,-263,1.079528273,,,
Department of Posts,2017,1,3275,3690,-415,1.126717557,,,
Department of Posts,2017,2,3184,3152,32,0.989949749,,,
Department of Posts,2017,3,3386,3484,-98,1.028942705,,,
Department of Posts,2017,4,3763,3501,262,0.930374701,,,
Department of Posts,2017,5,4317,4438,-121,1.028028724,,,
Department of Posts,2017,6,2992,3028,-36,1.012032086,,,
Department of Posts,2017,7,3564,3092,472,0.867564534,,,
Department of Posts,2017,8,4033,4125,-92,1.022811803,,,
Department of Posts,2017,9,3868,3642,226,0.941571872,,,
Department of Posts,2017,10,3215,3485,-270,1.083981337,,,
Department of Posts,2017,11,4396,3938,458,0.895814377,,,
Department of Posts,2017,12,5597,4344,1253,0.77613007,,,
Department of Posts,2018,1,2830,4681,-1851,1.654063604,,,
Department of Posts,2018,2,2648,2558,90,0.966012085,,,
Department of Posts,2018,3,2941,2703,238,0.919075145,,,
Department of Posts,2018,4,2948,2824,124,0.957937585,,,
Department of Posts,2018,5,3525,3561,-36,1.010212766,,,
Department of Posts,2018,6,3315,3168,147,0.955656109,,,
Department of Posts,2018,7,3864,3683,181,0.95315735,,,
Department of Posts,2018,8,4267,3774,493,0.884462151,,,
Department of Posts,2018,9,4042,3790,252,0.937654626,,,
Department of Posts,2018,10,3924,4319,-395,1.100662589,,,
Department of Posts,2018,11,3185,3339,-154,1.048351648,,,
Department of Posts,2018,12,3935,3656,279,0.92909784,,,
Department of Posts,2019,1,4230,4478,-248,1.058628842,,,
Department of Posts,2019,2,3536,3592,-56,1.015837104,,,
Department of Posts,2019,3,3290,3128,162,0.950759878,,,
Department of Posts,2019,4,3103,3214,-111,1.035771834,,,
Department of Posts,2019,5,3087,3612,-525,1.170068027,,,
Department of Posts,2019,6,3399,3216,183,0.946160635,,,
Department of Posts,2019,7,4119,4105,14,0.996601117,,,
Department of Posts,2019,8,3854,3697,157,0.959263103,,,
Department of Posts,2019,9,3636,3721,-85,1.023377338,,,
Department of Posts,2019,10,3979,4113,-134,1.033676803,,,
Department of Posts,2019,11,74,145,-71,1.959459459,,,
Department of Public Enterprises,2016,1,34,32,2,0.941176471,,,
Department of Public Enterprises,2016,2,69,62,7,0.898550725,,,
Department of Public Enterprises,2016,3,45,52,-7,1.155555556,,,
Department of Public Enterprises,2016,4,68,57,11,0.838235294,,,
Department of Public Enterprises,2016,5,63,68,-5,1.079365079,,,
Department of Public Enterprises,2016,6,108,55,53,0.509259259,,,
Department of Public Enterprises,2016,7,66,125,-59,1.893939394,,,
Department of Public Enterprises,2016,8,124,115,9,0.927419355,,,
Department of Public Enterprises,2016,9,66,65,1,0.984848485,,,
Department of Public Enterprises,2016,10,101,82,19,0.811881188,,,
Department of Public Enterprises,2016,11,100,119,-19,1.19,,,
Department of Public Enterprises,2016,12,77,56,21,0.727272727,,,
Department of Public Enterprises,2017,1,83,64,19,0.771084337,,,
Department of Public Enterprises,2017,2,95,111,-16,1.168421053,,,
Department of Public Enterprises,2017,3,112,76,36,0.678571429,,,
Department of Public Enterprises,2017,4,182,4,178,0.021978022,,,
Department of Public Enterprises,2017,5,84,288,-204,3.428571429,,,
Department of Public Enterprises,2017,6,88,59,29,0.670454545,,,
Department of Public Enterprises,2017,7,124,107,17,0.862903226,,,
Department of Public Enterprises,2017,8,109,94,15,0.862385321,,,
Department of Public Enterprises,2017,9,77,104,-27,1.350649351,,,
Department of Public Enterprises,2017,10,71,38,33,0.535211268,,,
Department of Public Enterprises,2017,11,111,143,-32,1.288288288,,,
Department of Public Enterprises,2017,12,84,102,-18,1.214285714,,,
Department of Public Enterprises,2018,1,46,90,-44,1.956521739,,,
Department of Public Enterprises,2018,2,33,30,3,0.909090909,,,
Department of Public Enterprises,2018,3,61,50,11,0.819672131,,,
Department of Public Enterprises,2018,4,67,40,27,0.597014925,,,
Department of Public Enterprises,2018,5,178,151,27,0.848314607,,,
Department of Public Enterprises,2018,6,65,120,-55,1.846153846,,,
Department of Public Enterprises,2018,7,87,82,5,0.942528736,,,
Department of Public Enterprises,2018,8,90,63,27,0.7,,,
Department of Public Enterprises,2018,9,178,94,84,0.528089888,,,
Department of Public Enterprises,2018,10,96,205,-109,2.135416667,,,
Department of Public Enterprises,2018,11,53,74,-21,1.396226415,,,
Department of Public Enterprises,2018,12,69,52,17,0.753623188,,,
Department of Public Enterprises,2019,1,79,78,1,0.987341772,,,
Department of Public Enterprises,2019,2,65,73,-8,1.123076923,,,
Department of Public Enterprises,2019,3,81,68,13,0.839506173,,,
Department of Public Enterprises,2019,4,56,59,-3,1.053571429,,,
Department of Public Enterprises,2019,5,74,93,-19,1.256756757,,,
Department of Public Enterprises,2019,6,82,49,33,0.597560976,,,
Department of Public Enterprises,2019,7,87,105,-18,1.206896552,,,
Department of Public Enterprises,2019,8,72,85,-13,1.180555556,,,
Department of Public Enterprises,2019,9,55,30,25,0.545454545,,,
Department of Public Enterprises,2019,10,44,82,-38,1.863636364,,,
Department of Revenue,2016,1,946,175,771,0.184989429,,,
Department of Revenue,2016,2,1149,364,785,0.316797215,,,
Department of Revenue,2016,3,1886,2291,-405,1.214740191,,,
Department of Revenue,2016,4,1262,1200,62,0.950871632,,,
Department of Revenue,2016,5,1051,760,291,0.723120837,,,
Department of Revenue,2016,6,1534,1604,-70,1.045632334,,,
Department of Revenue,2016,7,1262,995,267,0.788431062,,,
Department of Revenue,2016,8,1452,2046,-594,1.409090909,,,
Department of Revenue,2016,9,1307,850,457,0.6503443,,,
Department of Revenue,2016,10,1233,1575,-342,1.277372263,,,
Department of Revenue,2016,11,2775,1904,871,0.686126126,,,
Department of Revenue,2016,12,5101,5175,-74,1.014506959,,,
Department of Revenue,2017,1,2897,3690,-793,1.273731446,,,
Department of Revenue,2017,2,2307,2282,25,0.989163416,,,
Department of Revenue,2017,3,2197,2407,-210,1.095584888,,,
Department of Revenue,2017,4,1922,1645,277,0.855879292,,,
Department of Revenue,2017,5,2606,2351,255,0.902148887,,,
Department of Revenue,2017,6,4273,3425,848,0.801544582,,,
Department of Revenue,2017,7,4551,4217,334,0.926609536,,,
Department of Revenue,2017,8,3488,3084,404,0.884174312,,,
Department of Revenue,2017,9,3390,2736,654,0.807079646,,,
Department of Revenue,2017,10,3697,2495,1202,0.674871517,,,
Department of Revenue,2017,11,3161,3562,-401,1.126858589,,,
Department of Revenue,2017,12,1866,3119,-1253,1.671489818,,,
Department of Revenue,2018,1,2021,2347,-326,1.161306284,,,
Department of Revenue,2018,2,1855,1879,-24,1.012938005,,,
Department of Revenue,2018,3,1816,1754,62,0.965859031,,,
Department of Revenue,2018,4,1754,1844,-90,1.051311288,,,
Department of Revenue,2018,5,2133,2181,-48,1.022503516,,,
Department of Revenue,2018,6,1702,1872,-170,1.099882491,,,
Department of Revenue,2018,7,2295,2070,225,0.901960784,,,
Department of Revenue,2018,8,1739,1800,-61,1.035077631,,,
Department of Revenue,2018,9,1627,1018,609,0.625691457,,,
Department of Revenue,2018,10,1616,612,1004,0.378712871,,,
Department of Revenue,2018,11,1312,543,769,0.413871951,,,
Department of Revenue,2018,12,1717,808,909,0.470588235,,,
Department of Revenue,2019,1,1879,718,1161,0.382118148,,,
Department of Revenue,2019,2,1533,1277,256,0.833007175,,,
Department of Revenue,2019,3,1377,1636,-259,1.188090051,,,
Department of Revenue,2019,4,1127,847,280,0.751552795,,,
Department of Revenue,2019,5,985,3663,-2678,3.718781726,,,
Department of Revenue,2019,6,1676,2594,-918,1.547732697,,,
Department of Revenue,2019,7,2057,1510,547,0.734078755,,,
Department of Revenue,2019,8,1588,1789,-201,1.126574307,,,
Department of Revenue,2019,9,1796,2540,-744,1.414253898,,,
Department of Revenue,2019,10,1646,1745,-99,1.060145808,,,
Department of Revenue,2019,11,57,89,-32,1.561403509,,,
Department of Rural Development,2016,1,206,65,141,0.315533981,,,
Department of Rural Development,2016,2,296,231,65,0.780405405,,,
Department of Rural Development,2016,3,311,199,112,0.639871383,,,
Department of Rural Development,2016,4,307,61,246,0.198697068,,,
Department of Rural Development,2016,5,279,146,133,0.523297491,,,
Department of Rural Development,2016,6,302,107,195,0.354304636,,,
Department of Rural Development,2016,7,311,353,-42,1.135048232,,,
Department of Rural Development,2016,8,344,631,-287,1.834302326,,,
Department of Rural Development,2016,9,326,371,-45,1.13803681,,,
Department of Rural Development,2016,10,318,299,19,0.940251572,,,
Department of Rural Development,2016,11,232,271,-39,1.168103448,,,
Department of Rural Development,2016,12,366,363,3,0.991803279,,,
Department of Rural Development,2017,1,308,232,76,0.753246753,,,
Department of Rural Development,2017,2,279,141,138,0.505376344,,,
Department of Rural Development,2017,3,517,275,242,0.531914894,,,
Department of Rural Development,2017,4,328,250,78,0.762195122,,,
Department of Rural Development,2017,5,609,871,-262,1.430213465,,,
Department of Rural Development,2017,6,484,574,-90,1.185950413,,,
Department of Rural Development,2017,7,425,400,25,0.941176471,,,
Department of Rural Development,2017,8,398,328,70,0.824120603,,,
Department of Rural Development,2017,9,432,207,225,0.479166667,,,
Department of Rural Development,2017,10,362,415,-53,1.14640884,,,
Department of Rural Development,2017,11,397,451,-54,1.136020151,,,
Department of Rural Development,2017,12,360,345,15,0.958333333,,,
Department of Rural Development,2018,1,289,368,-79,1.273356401,,,
Department of Rural Development,2018,2,246,314,-68,1.276422764,,,
Department of Rural Development,2018,3,277,212,65,0.76534296,,,
Department of Rural Development,2018,4,265,358,-93,1.350943396,,,
Department of Rural Development,2018,5,407,409,-2,1.004914005,,,
Department of Rural Development,2018,6,285,248,37,0.870175439,,,
Department of Rural Development,2018,7,383,365,18,0.953002611,,,
Department of Rural Development,2018,8,321,277,44,0.862928349,,,
Department of Rural Development,2018,9,396,247,149,0.623737374,,,
Department of Rural Development,2018,10,350,274,76,0.782857143,,,
Department of Rural Development,2018,11,230,164,66,0.713043478,,,
Department of Rural Development,2018,12,327,276,51,0.844036697,,,
Department of Rural Development,2019,1,415,378,37,0.910843373,,,
Department of Rural Development,2019,2,324,585,-261,1.805555556,,,
Department of Rural Development,2019,3,368,362,6,0.983695652,,,
Department of Rural Development,2019,4,251,196,55,0.780876494,,,
Department of Rural Development,2019,5,242,69,173,0.285123967,,,
Department of Rural Development,2019,6,449,504,-55,1.122494432,,,
Department of Rural Development,2019,7,573,367,206,0.640488656,,,
Department of Rural Development,2019,8,598,198,400,0.331103679,,,
Department of Rural Development,2019,9,638,643,-5,1.007836991,,,
Department of Rural Development,2019,10,401,842,-441,2.099750623,,,
Department of Rural Development,2019,11,9,24,-15,2.666666667,,,
Department of School Education and Literacy,2016,1,1010,207,803,0.204950495,,,
Department of School Education and Literacy,2016,2,1380,1242,138,0.9,,,
Department of School Education and Literacy,2016,3,2211,2396,-185,1.083672546,,,
Department of School Education and Literacy,2016,4,1794,1763,31,0.982720178,,,
Department of School Education and Literacy,2016,5,1625,1885,-260,1.16,,,
Department of School Education and Literacy,2016,6,1745,1381,364,0.791404011,,,
Department of School Education and Literacy,2016,7,1388,1468,-80,1.057636888,,,
Department of School Education and Literacy,2016,8,1543,1642,-99,1.064160726,,,
Department of School Education and Literacy,2016,9,1397,1038,359,0.743020759,,,
Department of School Education and Literacy,2016,10,1018,1220,-202,1.198428291,,,
Department of School Education and Literacy,2016,11,1074,1091,-17,1.015828678,,,
Department of School Education and Literacy,2016,12,1685,1027,658,0.609495549,,,
Department of School Education and Literacy,2017,1,1186,1728,-542,1.456998314,,,
Department of School Education and Literacy,2017,2,1625,1712,-87,1.053538462,,,
Department of School Education and Literacy,2017,3,2065,1542,523,0.746731235,,,
Department of School Education and Literacy,2017,4,2012,1671,341,0.830516899,,,
Department of School Education and Literacy,2017,5,1824,2124,-300,1.164473684,,,
Department of School Education and Literacy,2017,6,1643,1738,-95,1.057821059,,,
Department of School Education and Literacy,2017,7,1564,1888,-324,1.207161125,,,
Department of School Education and Literacy,2017,8,1413,1494,-81,1.057324841,,,
Department of School Education and Literacy,2017,9,1459,1193,266,0.817683345,,,
Department of School Education and Literacy,2017,10,1080,1276,-196,1.181481481,,,
Department of School Education and Literacy,2017,11,1316,1090,226,0.828267477,,,
Department of School Education and Literacy,2017,12,919,1245,-326,1.354733406,,,
Department of School Education and Literacy,2018,1,960,916,44,0.954166667,,,
Department of School Education and Literacy,2018,2,994,1045,-51,1.051307847,,,
Department of School Education and Literacy,2018,3,1392,955,437,0.686063218,,,
Department of School Education and Literacy,2018,4,1891,1496,395,0.791115812,,,
Department of School Education and Literacy,2018,5,1445,1685,-240,1.166089965,,,
Department of School Education and Literacy,2018,6,1275,1223,52,0.959215686,,,
Department of School Education and Literacy,2018,7,1552,1903,-351,1.226159794,,,
Department of School Education and Literacy,2018,8,1308,1362,-54,1.041284404,,,
Department of School Education and Literacy,2018,9,1096,1079,17,0.984489051,,,
Department of School Education and Literacy,2018,10,927,1102,-175,1.188781014,,,
Department of School Education and Literacy,2018,11,765,852,-87,1.11372549,,,
Department of School Education and Literacy,2018,12,848,886,-38,1.044811321,,,
Department of School Education and Literacy,2019,1,1018,1053,-35,1.034381139,,,
Department of School Education and Literacy,2019,2,1049,795,254,0.757864633,,,
Department of School Education and Literacy,2019,3,1286,898,388,0.698289269,,,
Department of School Education and Literacy,2019,4,1049,1594,-545,1.519542421,,,
Department of School Education and Literacy,2019,5,1046,1093,-47,1.044933078,,,
Department of School Education and Literacy,2019,6,1541,1250,291,0.811161583,,,
Department of School Education and Literacy,2019,7,1716,1437,279,0.837412587,,,
Department of School Education and Literacy,2019,8,1415,1513,-98,1.069257951,,,
Department of School Education and Literacy,2019,9,1882,1541,341,0.818809777,,,
Department of School Education and Literacy,2019,10,1238,1342,-104,1.084006462,,,
Department of School Education and Literacy,2019,11,27,48,-21,1.777777778,,,
Department of Science and Technology,2016,1,168,50,118,0.297619048,,,
Department of Science and Technology,2016,2,230,130,100,0.565217391,,,
Department of Science and Technology,2016,3,184,112,72,0.608695652,,,
Department of Science and Technology,2016,4,152,142,10,0.934210526,,,
Department of Science and Technology,2016,5,159,266,-107,1.672955975,,,
Department of Science and Technology,2016,6,184,131,53,0.711956522,,,
Department of Science and Technology,2016,7,210,140,70,0.666666667,,,
Department of Science and Technology,2016,8,162,141,21,0.87037037,,,
Department of Science and Technology,2016,9,193,219,-26,1.134715026,,,
Department of Science and Technology,2016,10,136,126,10,0.926470588,,,
Department of Science and Technology,2016,11,151,174,-23,1.152317881,,,
Department of Science and Technology,2016,12,154,117,37,0.75974026,,,
Department of Science and Technology,2017,1,160,221,-61,1.38125,,,
Department of Science and Technology,2017,2,148,182,-34,1.22972973,,,
Department of Science and Technology,2017,3,274,268,6,0.97810219,,,
Department of Science and Technology,2017,4,170,241,-71,1.417647059,,,
Department of Science and Technology,2017,5,203,206,-3,1.014778325,,,
Department of Science and Technology,2017,6,227,223,4,0.982378855,,,
Department of Science and Technology,2017,7,237,266,-29,1.122362869,,,
Department of Science and Technology,2017,8,176,176,0,1,,,
Department of Science and Technology,2017,9,243,225,18,0.925925926,,,
Department of Science and Technology,2017,10,157,157,0,1,,,
Department of Science and Technology,2017,11,193,189,4,0.979274611,,,
Department of Science and Technology,2017,12,173,214,-41,1.23699422,,,
Department of Science and Technology,2018,1,158,160,-2,1.012658228,,,
Department of Science and Technology,2018,2,118,135,-17,1.144067797,,,
Department of Science and Technology,2018,3,116,111,5,0.956896552,,,
Department of Science and Technology,2018,4,138,125,13,0.905797101,,,
Department of Science and Technology,2018,5,188,213,-25,1.132978723,,,
Department of Science and Technology,2018,6,140,136,4,0.971428571,,,
Department of Science and Technology,2018,7,191,183,8,0.958115183,,,
Department of Science and Technology,2018,8,220,193,27,0.877272727,,,
Department of Science and Technology,2018,9,186,172,14,0.924731183,,,
Department of Science and Technology,2018,10,182,219,-37,1.203296703,,,
Department of Science and Technology,2018,11,110,120,-10,1.090909091,,,
Department of Science and Technology,2018,12,175,121,54,0.691428571,,,
Department of Science and Technology,2019,1,212,189,23,0.891509434,,,
Department of Science and Technology,2019,2,137,216,-79,1.576642336,,,
Department of Science and Technology,2019,3,141,140,1,0.992907801,,,
Department of Science and Technology,2019,4,93,119,-26,1.279569892,,,
Department of Science and Technology,2019,5,72,88,-16,1.222222222,,,
Department of Science and Technology,2019,6,102,77,25,0.754901961,,,
Department of Science and Technology,2019,7,178,135,43,0.758426966,,,
Department of Science and Technology,2019,8,172,195,-23,1.13372093,,,
Department of Science and Technology,2019,9,190,165,25,0.868421053,,,
Department of Science and Technology,2019,10,120,156,-36,1.3,,,
Department of Science and Technology,2019,11,5,4,1,0.8,,,
Department of Scientific & Industrial Research,2016,1,53,18,35,0.339622642,,,
Department of Scientific & Industrial Research,2016,2,75,23,52,0.306666667,,,
Department of Scientific & Industrial Research,2016,3,99,82,17,0.828282828,,,
Department of Scientific & Industrial Research,2016,4,96,46,50,0.479166667,,,
Department of Scientific & Industrial Research,2016,5,81,139,-58,1.716049383,,,
Department of Scientific & Industrial Research,2016,6,122,67,55,0.549180328,,,
Department of Scientific & Industrial Research,2016,7,121,115,6,0.950413223,,,
Department of Scientific & Industrial Research,2016,8,96,162,-66,1.6875,,,
Department of Scientific & Industrial Research,2016,9,78,63,15,0.807692308,,,
Department of Scientific & Industrial Research,2016,10,74,72,2,0.972972973,,,
Department of Scientific & Industrial Research,2016,11,57,54,3,0.947368421,,,
Department of Scientific & Industrial Research,2016,12,88,96,-8,1.090909091,,,
Department of Scientific & Industrial Research,2017,1,101,63,38,0.623762376,,,
Department of Scientific & Industrial Research,2017,2,98,82,16,0.836734694,,,
Department of Scientific & Industrial Research,2017,3,110,138,-28,1.254545455,,,
Department of Scientific & Industrial Research,2017,4,104,48,56,0.461538462,,,
Department of Scientific & Industrial Research,2017,5,121,88,33,0.727272727,,,
Department of Scientific & Industrial Research,2017,6,151,109,42,0.721854305,,,
Department of Scientific & Industrial Research,2017,7,151,90,61,0.59602649,,,
Department of Scientific & Industrial Research,2017,8,130,131,-1,1.007692308,,,
Department of Scientific & Industrial Research,2017,9,142,313,-171,2.204225352,,,
Department of Scientific & Industrial Research,2017,10,156,158,-2,1.012820513,,,
Department of Scientific & Industrial Research,2017,11,143,148,-5,1.034965035,,,
Department of Scientific & Industrial Research,2017,12,88,105,-17,1.193181818,,,
Department of Scientific & Industrial Research,2018,1,80,27,53,0.3375,,,
Department of Scientific & Industrial Research,2018,2,60,102,-42,1.7,,,
Department of Scientific & Industrial Research,2018,3,81,61,20,0.75308642,,,
Department of Scientific & Industrial Research,2018,4,86,46,40,0.534883721,,,
Department of Scientific & Industrial Research,2018,5,123,159,-36,1.292682927,,,
Department of Scientific & Industrial Research,2018,6,75,42,33,0.56,,,
Department of Scientific & Industrial Research,2018,7,100,179,-79,1.79,,,
Department of Scientific & Industrial Research,2018,8,112,67,45,0.598214286,,,
Department of Scientific & Industrial Research,2018,9,85,76,9,0.894117647,,,
Department of Scientific & Industrial Research,2018,10,71,73,-2,1.028169014,,,
Department of Scientific & Industrial Research,2018,11,79,52,27,0.658227848,,,
Department of Scientific & Industrial Research,2018,12,86,59,27,0.686046512,,,
Department of Scientific & Industrial Research,2019,1,70,108,-38,1.542857143,,,
Department of Scientific & Industrial Research,2019,2,99,125,-26,1.262626263,,,
Department of Scientific & Industrial Research,2019,3,113,154,-41,1.362831858,,,
Department of Scientific & Industrial Research,2019,4,83,59,24,0.710843373,,,
Department of Scientific & Industrial Research,2019,5,52,31,21,0.596153846,,,
Department of Scientific & Industrial Research,2019,6,80,57,23,0.7125,,,
Department of Scientific & Industrial Research,2019,7,89,66,23,0.741573034,,,
Department of Scientific & Industrial Research,2019,8,73,43,30,0.589041096,,,
Department of Scientific & Industrial Research,2019,9,115,74,41,0.643478261,,,
Department of Scientific & Industrial Research,2019,10,80,78,2,0.975,,,
Department of Scientific & Industrial Research,2019,11,2,5,-3,2.5,,,
Department of Social Justice and Empowerment,2016,1,312,175,137,0.560897436,,,
Department of Social Justice and Empowerment,2016,2,368,308,60,0.836956522,,,
Department of Social Justice and Empowerment,2016,3,362,312,50,0.861878453,,,
Department of Social Justice and Empowerment,2016,4,300,400,-100,1.333333333,,,
Department of Social Justice and Empowerment,2016,5,311,369,-58,1.186495177,,,
Department of Social Justice and Empowerment,2016,6,362,352,10,0.972375691,,,
Department of Social Justice and Empowerment,2016,7,355,299,56,0.842253521,,,
Department of Social Justice and Empowerment,2016,8,459,324,135,0.705882353,,,
Department of Social Justice and Empowerment,2016,9,383,303,80,0.791122715,,,
Department of Social Justice and Empowerment,2016,10,373,456,-83,1.222520107,,,
Department of Social Justice and Empowerment,2016,11,323,293,30,0.907120743,,,
Department of Social Justice and Empowerment,2016,12,402,427,-25,1.062189055,,,
Department of Social Justice and Empowerment,2017,1,348,301,47,0.864942529,,,
Department of Social Justice and Empowerment,2017,2,316,394,-78,1.246835443,,,
Department of Social Justice and Empowerment,2017,3,458,446,12,0.973799127,,,
Department of Social Justice and Empowerment,2017,4,334,302,32,0.904191617,,,
Department of Social Justice and Empowerment,2017,5,416,382,34,0.918269231,,,
Department of Social Justice and Empowerment,2017,6,362,562,-200,1.552486188,,,
Department of Social Justice and Empowerment,2017,7,331,318,13,0.960725076,,,
Department of Social Justice and Empowerment,2017,8,423,388,35,0.917257683,,,
Department of Social Justice and Empowerment,2017,9,372,332,40,0.892473118,,,
Department of Social Justice and Empowerment,2017,10,260,292,-32,1.123076923,,,
Department of Social Justice and Empowerment,2017,11,329,313,16,0.951367781,,,
Department of Social Justice and Empowerment,2017,12,287,246,41,0.857142857,,,
Department of Social Justice and Empowerment,2018,1,236,204,32,0.86440678,,,
Department of Social Justice and Empowerment,2018,2,224,183,41,0.816964286,,,
Department of Social Justice and Empowerment,2018,3,290,225,65,0.775862069,,,
Department of Social Justice and Empowerment,2018,4,327,216,111,0.660550459,,,
Department of Social Justice and Empowerment,2018,5,429,355,74,0.827505828,,,
Department of Social Justice and Empowerment,2018,6,351,211,140,0.601139601,,,
Department of Social Justice and Empowerment,2018,7,365,279,86,0.764383562,,,
Department of Social Justice and Empowerment,2018,8,449,461,-12,1.026726058,,,
Department of Social Justice and Empowerment,2018,9,397,333,64,0.838790932,,,
Department of Social Justice and Empowerment,2018,10,368,434,-66,1.179347826,,,
Department of Social Justice and Empowerment,2018,11,313,293,20,0.936102236,,,
Department of Social Justice and Empowerment,2018,12,268,217,51,0.809701493,,,
Department of Social Justice and Empowerment,2019,1,444,381,63,0.858108108,,,
Department of Social Justice and Empowerment,2019,2,413,580,-167,1.404358354,,,
Department of Social Justice and Empowerment,2019,3,450,86,364,0.191111111,,,
Department of Social Justice and Empowerment,2019,4,326,192,134,0.588957055,,,
Department of Social Justice and Empowerment,2019,5,269,424,-155,1.576208178,,,
Department of Social Justice and Empowerment,2019,6,407,271,136,0.665847666,,,
Department of Social Justice and Empowerment,2019,7,531,422,109,0.79472693,,,
Department of Social Justice and Empowerment,2019,8,469,374,95,0.797441365,,,
Department of Social Justice and Empowerment,2019,9,626,719,-93,1.1485623,,,
Department of Social Justice and Empowerment,2019,10,415,848,-433,2.043373494,,,
Department of Social Justice and Empowerment,2019,11,13,19,-6,1.461538462,,,
Department of Space,2016,2,36,11,25,0.305555556,,,
Department of Space,2016,3,31,5,26,0.161290323,,,
Department of Space,2016,4,36,10,26,0.277777778,,,
Department of Space,2016,5,47,13,34,0.276595745,,,
Department of Space,2016,6,63,3,60,0.047619048,,,
Department of Space,2016,7,57,12,45,0.210526316,,,
Department of Space,2016,8,39,78,-39,2,,,
Department of Space,2016,9,39,19,20,0.487179487,,,
Department of Space,2016,10,40,30,10,0.75,,,
Department of Space,2016,11,38,122,-84,3.210526316,,,
Department of Space,2016,12,52,18,34,0.346153846,,,
Department of Space,2017,1,33,8,25,0.242424242,,,
Department of Space,2017,2,45,32,13,0.711111111,,,
Department of Space,2017,3,51,15,36,0.294117647,,,
Department of Space,2017,4,48,10,38,0.208333333,,,
Department of Space,2017,5,90,49,41,0.544444444,,,
Department of Space,2017,6,61,25,36,0.409836066,,,
Department of Space,2017,7,72,52,20,0.722222222,,,
Department of Space,2017,8,51,43,8,0.843137255,,,
Department of Space,2017,9,29,101,-72,3.482758621,,,
Department of Space,2017,10,43,106,-63,2.465116279,,,
Department of Space,2017,11,45,63,-18,1.4,,,
Department of Space,2017,12,33,53,-20,1.606060606,,,
Department of Space,2018,1,42,45,-3,1.071428571,,,
Department of Space,2018,2,29,41,-12,1.413793103,,,
Department of Space,2018,3,37,38,-1,1.027027027,,,
Department of Space,2018,4,49,30,19,0.612244898,,,
Department of Space,2018,5,90,56,34,0.622222222,,,
Department of Space,2018,6,26,38,-12,1.461538462,,,
Department of Space,2018,7,40,36,4,0.9,,,
Department of Space,2018,8,51,21,30,0.411764706,,,
Department of Space,2018,9,36,32,4,0.888888889,,,
Department of Space,2018,10,38,24,14,0.631578947,,,
Department of Space,2018,11,40,59,-19,1.475,,,
Department of Space,2018,12,63,78,-15,1.238095238,,,
Department of Space,2019,1,72,76,-4,1.055555556,,,
Department of Space,2019,2,41,91,-50,2.219512195,,,
Department of Space,2019,3,61,49,12,0.803278689,,,
Department of Space,2019,4,39,81,-42,2.076923077,,,
Department of Space,2019,5,39,105,-66,2.692307692,,,
Department of Space,2019,6,38,43,-5,1.131578947,,,
Department of Space,2019,7,60,80,-20,1.333333333,,,
Department of Space,2019,8,42,65,-23,1.547619048,,,
Department of Space,2019,9,159,19,140,0.119496855,,,
Department of Space,2019,10,65,23,42,0.353846154,,,
Department of Sports,2016,1,58,9,49,0.155172414,,,
Department of Sports,2016,2,87,22,65,0.252873563,,,
Department of Sports,2016,3,151,44,107,0.291390728,,,
Department of Sports,2016,4,176,113,63,0.642045455,,,
Department of Sports,2016,5,145,55,90,0.379310345,,,
Department of Sports,2016,6,163,224,-61,1.374233129,,,
Department of Sports,2016,7,168,263,-95,1.56547619,,,
Department of Sports,2016,8,929,182,747,0.19590958,,,
Department of Sports,2016,9,417,144,273,0.345323741,,,
Department of Sports,2016,10,176,566,-390,3.215909091,,,
Department of Sports,2016,11,129,512,-383,3.968992248,,,
Department of Sports,2016,12,170,79,91,0.464705882,,,
Department of Sports,2017,1,154,63,91,0.409090909,,,
Department of Sports,2017,2,133,57,76,0.428571429,,,
Department of Sports,2017,3,137,386,-249,2.817518248,,,
Department of Sports,2017,4,137,186,-49,1.357664234,,,
Department of Sports,2017,5,158,122,36,0.772151899,,,
Department of Sports,2017,6,135,103,32,0.762962963,,,
Department of Sports,2017,7,161,62,99,0.385093168,,,
Department of Sports,2017,8,200,255,-55,1.275,,,
Department of Sports,2017,9,161,474,-313,2.944099379,,,
Department of Sports,2017,10,133,59,74,0.443609023,,,
Department of Sports,2017,11,102,55,47,0.539215686,,,
Department of Sports,2017,12,75,264,-189,3.52,,,
Department of Sports,2018,1,90,132,-42,1.466666667,,,
Department of Sports,2018,2,104,145,-41,1.394230769,,,
Department of Sports,2018,3,80,40,40,0.5,,,
Department of Sports,2018,4,127,96,31,0.755905512,,,
Department of Sports,2018,5,152,197,-45,1.296052632,,,
Department of Sports,2018,6,83,67,16,0.807228916,,,
Department of Sports,2018,7,166,118,48,0.710843373,,,
Department of Sports,2018,8,107,106,1,0.990654206,,,
Department of Sports,2018,9,125,153,-28,1.224,,,
Department of Sports,2018,10,96,177,-81,1.84375,,,
Department of Sports,2018,11,81,71,10,0.87654321,,,
Department of Sports,2018,12,78,74,4,0.948717949,,,
Department of Sports,2019,1,115,82,33,0.713043478,,,
Department of Sports,2019,2,98,65,33,0.663265306,,,
Department of Sports,2019,3,118,75,43,0.63559322,,,
Department of Sports,2019,4,101,147,-46,1.455445545,,,
Department of Sports,2019,5,99,148,-49,1.494949495,,,
Department of Sports,2019,6,110,54,56,0.490909091,,,
Department of Sports,2019,7,132,88,44,0.666666667,,,
Department of Sports,2019,8,117,77,40,0.658119658,,,
Department of Sports,2019,9,175,144,31,0.822857143,,,
Department of Sports,2019,10,89,101,-12,1.134831461,,,
Department of Telecommunications,2016,1,4336,2199,2137,0.507149446,,,
Department of Telecommunications,2016,2,4755,4278,477,0.899684543,,,
Department of Telecommunications,2016,3,5118,5063,55,0.989253615,,,
Department of Telecommunications,2016,4,4806,5123,-317,1.065959218,,,
Department of Telecommunications,2016,5,5498,5296,202,0.963259367,,,
Department of Telecommunications,2016,6,6474,5581,893,0.862063639,,,
Department of Telecommunications,2016,7,6505,6297,208,0.968024596,,,
Department of Telecommunications,2016,8,7278,7149,129,0.98227535,,,
Department of Telecommunications,2016,9,7168,7243,-75,1.01046317,,,
Department of Telecommunications,2016,10,5560,6352,-792,1.142446043,,,
Department of Telecommunications,2016,11,4524,5078,-554,1.122458002,,,
Department of Telecommunications,2016,12,5130,3840,1290,0.748538012,,,
Department of Telecommunications,2017,1,5049,6461,-1412,1.279659338,,,
Department of Telecommunications,2017,2,4660,4918,-258,1.055364807,,,
Department of Telecommunications,2017,3,5569,5813,-244,1.04381397,,,
Department of Telecommunications,2017,4,6102,5414,688,0.887250082,,,
Department of Telecommunications,2017,5,6980,7437,-457,1.065472779,,,
Department of Telecommunications,2017,6,6745,6456,289,0.957153447,,,
Department of Telecommunications,2017,7,7977,7450,527,0.933935063,,,
Department of Telecommunications,2017,8,7775,8129,-354,1.045530547,,,
Department of Telecommunications,2017,9,7269,7115,154,0.978814142,,,
Department of Telecommunications,2017,10,6498,6393,105,0.983841182,,,
Department of Telecommunications,2017,11,6917,6260,657,0.905016626,,,
Department of Telecommunications,2017,12,5915,6217,-302,1.051056636,,,
Department of Telecommunications,2018,1,4945,5538,-593,1.11991911,,,
Department of Telecommunications,2018,2,4373,4724,-351,1.080265264,,,
Department of Telecommunications,2018,3,5168,4538,630,0.878095975,,,
Department of Telecommunications,2018,4,5265,5835,-570,1.108262108,,,
Department of Telecommunications,2018,5,6347,6269,78,0.987710729,,,
Department of Telecommunications,2018,6,4407,4220,187,0.957567506,,,
Department of Telecommunications,2018,7,6307,6310,-3,1.000475662,,,
Department of Telecommunications,2018,8,6039,6248,-209,1.034608379,,,
Department of Telecommunications,2018,9,5565,5657,-92,1.016531896,,,
Department of Telecommunications,2018,10,5481,5803,-322,1.058748404,,,
Department of Telecommunications,2018,11,4410,4292,118,0.97324263,,,
Department of Telecommunications,2018,12,5182,4801,381,0.926476264,,,
Department of Telecommunications,2019,1,5201,5358,-157,1.030186503,,,
Department of Telecommunications,2019,2,5859,5376,483,0.917562724,,,
Department of Telecommunications,2019,3,5210,4718,492,0.905566219,,,
Department of Telecommunications,2019,4,4793,5386,-593,1.123722095,,,
Department of Telecommunications,2019,5,4723,5097,-374,1.079186957,,,
Department of Telecommunications,2019,6,5381,4686,695,0.870841851,,,
Department of Telecommunications,2019,7,6382,6438,-56,1.008774679,,,
Department of Telecommunications,2019,8,5597,5436,161,0.97123459,,,
Department of Telecommunications,2019,9,5240,5371,-131,1.025,,,
Department of Telecommunications,2019,10,4676,4590,86,0.981608212,,,
Department of Telecommunications,2019,11,176,334,-158,1.897727273,,,
Department of Youth Affairs,2016,1,60,34,26,0.566666667,,,
Department of Youth Affairs,2016,2,62,73,-11,1.177419355,,,
Department of Youth Affairs,2016,3,79,89,-10,1.126582278,,,
Department of Youth Affairs,2016,4,46,40,6,0.869565217,,,
Department of Youth Affairs,2016,5,47,48,-1,1.021276596,,,
Department of Youth Affairs,2016,6,60,63,-3,1.05,,,
Department of Youth Affairs,2016,7,65,62,3,0.953846154,,,
Department of Youth Affairs,2016,8,55,54,1,0.981818182,,,
Department of Youth Affairs,2016,9,71,64,7,0.901408451,,,
Department of Youth Affairs,2016,10,53,48,5,0.905660377,,,
Department of Youth Affairs,2016,11,78,76,2,0.974358974,,,
Department of Youth Affairs,2016,12,85,73,12,0.858823529,,,
Department of Youth Affairs,2017,1,76,77,-1,1.013157895,,,
Department of Youth Affairs,2017,2,91,97,-6,1.065934066,,,
Department of Youth Affairs,2017,3,90,92,-2,1.022222222,,,
Department of Youth Affairs,2017,4,78,64,14,0.820512821,,,
Department of Youth Affairs,2017,5,89,103,-14,1.157303371,,,
Department of Youth Affairs,2017,6,119,102,17,0.857142857,,,
Department of Youth Affairs,2017,7,99,122,-23,1.232323232,,,
Department of Youth Affairs,2017,8,110,96,14,0.872727273,,,
Department of Youth Affairs,2017,9,110,96,14,0.872727273,,,
Department of Youth Affairs,2017,10,110,119,-9,1.081818182,,,
Department of Youth Affairs,2017,11,111,132,-21,1.189189189,,,
Department of Youth Affairs,2017,12,95,71,24,0.747368421,,,
Department of Youth Affairs,2018,1,82,67,15,0.817073171,,,
Department of Youth Affairs,2018,2,46,50,-4,1.086956522,,,
Department of Youth Affairs,2018,3,79,98,-19,1.240506329,,,
Department of Youth Affairs,2018,4,78,84,-6,1.076923077,,,
Department of Youth Affairs,2018,5,110,117,-7,1.063636364,,,
Department of Youth Affairs,2018,6,32,32,0,1,,,
Department of Youth Affairs,2018,7,57,44,13,0.771929825,,,
Department of Youth Affairs,2018,8,72,56,16,0.777777778,,,
Department of Youth Affairs,2018,9,135,50,85,0.37037037,,,
Department of Youth Affairs,2018,10,73,144,-71,1.97260274,,,
Department of Youth Affairs,2018,11,60,62,-2,1.033333333,,,
Department of Youth Affairs,2018,12,85,79,6,0.929411765,,,
Department of Youth Affairs,2019,1,90,112,-22,1.244444444,,,
Department of Youth Affairs,2019,2,82,62,20,0.756097561,,,
Department of Youth Affairs,2019,3,97,102,-5,1.051546392,,,
Department of Youth Affairs,2019,4,62,62,0,1,,,
Department of Youth Affairs,2019,5,57,70,-13,1.228070175,,,
Department of Youth Affairs,2019,6,101,68,33,0.673267327,,,
Department of Youth Affairs,2019,7,83,58,25,0.698795181,,,
Department of Youth Affairs,2019,8,84,91,-7,1.083333333,,,
Department of Youth Affairs,2019,9,140,77,63,0.55,,,
Department of Youth Affairs,2019,10,79,137,-58,1.734177215,,,
Department of Youth Affairs,2019,11,2,10,-8,5,,,
Government of Andaman & Nicobar,2016,1,30,2,28,0.066666667,,,
Government of Andaman & Nicobar,2016,2,32,20,12,0.625,,,
Government of Andaman & Nicobar,2016,3,36,7,29,0.194444444,,,
Government of Andaman & Nicobar,2016,4,26,11,15,0.423076923,,,
Government of Andaman & Nicobar,2016,5,29,19,10,0.655172414,,,
Government of Andaman & Nicobar,2016,6,41,15,26,0.365853659,,,
Government of Andaman & Nicobar,2016,7,40,42,-2,1.05,,,
Government of Andaman & Nicobar,2016,8,50,34,16,0.68,,,
Government of Andaman & Nicobar,2016,9,50,13,37,0.26,,,
Government of Andaman & Nicobar,2016,10,41,9,32,0.219512195,,,
Government of Andaman & Nicobar,2016,11,27,2,25,0.074074074,,,
Government of Andaman & Nicobar,2016,12,69,41,28,0.594202899,,,
Government of Andaman & Nicobar,2017,1,40,11,29,0.275,,,
Government of Andaman & Nicobar,2017,2,41,59,-18,1.43902439,,,
Government of Andaman & Nicobar,2017,3,38,15,23,0.394736842,,,
Government of Andaman & Nicobar,2017,4,39,28,11,0.717948718,,,
Government of Andaman & Nicobar,2017,5,42,100,-58,2.380952381,,,
Government of Andaman & Nicobar,2017,6,25,169,-144,6.76,,,
Government of Andaman & Nicobar,2017,7,42,73,-31,1.738095238,,,
Government of Andaman & Nicobar,2017,8,36,26,10,0.722222222,,,
Government of Andaman & Nicobar,2017,9,52,60,-8,1.153846154,,,
Government of Andaman & Nicobar,2017,10,38,49,-11,1.289473684,,,
Government of Andaman & Nicobar,2017,11,26,36,-10,1.384615385,,,
Government of Andaman & Nicobar,2017,12,40,30,10,0.75,,,
Government of Andaman & Nicobar,2018,1,37,43,-6,1.162162162,,,
Government of Andaman & Nicobar,2018,2,36,41,-5,1.138888889,,,
Government of Andaman & Nicobar,2018,3,37,31,6,0.837837838,,,
Government of Andaman & Nicobar,2018,4,28,26,2,0.928571429,,,
Government of Andaman & Nicobar,2018,5,38,30,8,0.789473684,,,
Government of Andaman & Nicobar,2018,6,22,20,2,0.909090909,,,
Government of Andaman & Nicobar,2018,7,35,35,0,1,,,
Government of Andaman & Nicobar,2018,8,36,25,11,0.694444444,,,
Government of Andaman & Nicobar,2018,9,28,37,-9,1.321428571,,,
Government of Andaman & Nicobar,2018,10,36,37,-1,1.027777778,,,
Government of Andaman & Nicobar,2018,11,49,33,16,0.673469388,,,
Government of Andaman & Nicobar,2018,12,52,26,26,0.5,,,
Government of Andaman & Nicobar,2019,1,65,40,25,0.615384615,,,
Government of Andaman & Nicobar,2019,2,45,59,-14,1.311111111,,,
Government of Andaman & Nicobar,2019,3,33,33,0,1,,,
Government of Andaman & Nicobar,2019,4,23,11,12,0.47826087,,,
Government of Andaman & Nicobar,2019,5,41,114,-73,2.780487805,,,
Government of Andaman & Nicobar,2019,6,46,62,-16,1.347826087,,,
Government of Andaman & Nicobar,2019,7,61,67,-6,1.098360656,,,
Government of Andaman & Nicobar,2019,8,69,53,16,0.768115942,,,
Government of Andaman & Nicobar,2019,9,72,41,31,0.569444444,,,
Government of Andaman & Nicobar,2019,10,58,66,-8,1.137931034,,,
Government of Andhra Pradesh,2016,1,325,1,324,0.003076923,,,
Government of Andhra Pradesh,2016,3,556,2,554,0.003597122,,,
Government of Andhra Pradesh,2016,4,510,2,508,0.003921569,,,
Government of Andhra Pradesh,2016,5,563,2,561,0.003552398,,,
Government of Andhra Pradesh,2016,6,505,2,503,0.003960396,,,
Government of Andhra Pradesh,2016,7,554,4,550,0.007220217,,,
Government of Andhra Pradesh,2016,8,622,2,620,0.003215434,,,
Government of Andhra Pradesh,2016,9,506,3,503,0.005928854,,,
Government of Andhra Pradesh,2016,10,547,4,543,0.007312614,,,
Government of Andhra Pradesh,2016,12,650,3,647,0.004615385,,,
Government of Andhra Pradesh,2017,1,548,1,547,0.001824818,,,
Government of Andhra Pradesh,2017,3,549,2,547,0.003642987,,,
Government of Andhra Pradesh,2017,4,511,3,508,0.005870841,,,
Government of Andhra Pradesh,2017,5,584,1,583,0.001712329,,,
Government of Andhra Pradesh,2017,6,716,4,712,0.005586592,,,
Government of Andhra Pradesh,2017,7,780,2,778,0.002564103,,,
Government of Andhra Pradesh,2017,8,602,4,598,0.006644518,,,
Government of Andhra Pradesh,2017,9,573,3,570,0.005235602,,,
Government of Andhra Pradesh,2017,10,466,2,464,0.004291845,,,
Government of Andhra Pradesh,2017,11,485,3,482,0.006185567,,,
Government of Andhra Pradesh,2017,12,519,5,514,0.009633911,,,
Government of Andhra Pradesh,2018,1,569,1,568,0.001757469,,,
Government of Andhra Pradesh,2018,3,418,2,416,0.004784689,,,
Government of Andhra Pradesh,2018,4,362,1,361,0.002762431,,,
Government of Andhra Pradesh,2018,5,563,10,553,0.017761989,,,
Government of Andhra Pradesh,2018,6,560,18,542,0.032142857,,,
Government of Andhra Pradesh,2018,7,628,31,597,0.049363057,,,
Government of Andhra Pradesh,2018,8,395,17,378,0.043037975,,,
Government of Andhra Pradesh,2018,9,348,13,335,0.037356322,,,
Government of Andhra Pradesh,2018,10,480,25,455,0.052083333,,,
Government of Andhra Pradesh,2018,11,312,16,296,0.051282051,,,
Government of Andhra Pradesh,2018,12,304,12,292,0.039473684,,,
Government of Andhra Pradesh,2019,1,493,35,458,0.070993915,,,
Government of Andhra Pradesh,2019,2,462,2056,-1594,4.45021645,,,
Government of Andhra Pradesh,2019,3,387,15,372,0.03875969,,,
Government of Andhra Pradesh,2019,4,321,222,99,0.691588785,,,
Government of Andhra Pradesh,2019,5,322,7,315,0.02173913,,,
Government of Andhra Pradesh,2019,6,442,16,426,0.036199095,,,
Government of Andhra Pradesh,2019,7,533,18,515,0.033771107,,,
Government of Andhra Pradesh,2019,8,495,25,470,0.050505051,,,
Government of Andhra Pradesh,2019,9,511,19,492,0.037181996,,,
Government of Andhra Pradesh,2019,10,476,21,455,0.044117647,,,
Government of Arunachal Pradesh,2016,1,18,2,16,0.111111111,,,
Government of Arunachal Pradesh,2016,2,18,2,16,0.111111111,,,
Government of Arunachal Pradesh,2016,4,18,1,17,0.055555556,,,
Government of Arunachal Pradesh,2016,5,14,1,13,0.071428571,,,
Government of Arunachal Pradesh,2016,6,33,3,30,0.090909091,,,
Government of Arunachal Pradesh,2016,9,35,1,34,0.028571429,,,
Government of Arunachal Pradesh,2016,11,38,3,35,0.078947368,,,
Government of Arunachal Pradesh,2017,1,31,1,30,0.032258065,,,
Government of Arunachal Pradesh,2017,2,41,1,40,0.024390244,,,
Government of Arunachal Pradesh,2017,3,50,3,47,0.06,,,
Government of Arunachal Pradesh,2017,5,47,1,46,0.021276596,,,
Government of Arunachal Pradesh,2017,6,51,8,43,0.156862745,,,
Government of Arunachal Pradesh,2017,7,70,47,23,0.671428571,,,
Government of Arunachal Pradesh,2017,8,33,34,-1,1.03030303,,,
Government of Arunachal Pradesh,2017,9,34,70,-36,2.058823529,,,
Government of Arunachal Pradesh,2017,10,18,13,5,0.722222222,,,
Government of Arunachal Pradesh,2017,11,28,4,24,0.142857143,,,
Government of Arunachal Pradesh,2017,12,32,12,20,0.375,,,
Government of Arunachal Pradesh,2018,1,21,73,-52,3.476190476,,,
Government of Arunachal Pradesh,2018,2,25,3,22,0.12,,,
Government of Arunachal Pradesh,2018,3,33,23,10,0.696969697,,,
Government of Arunachal Pradesh,2018,4,23,538,-515,23.39130435,,,
Government of Arunachal Pradesh,2018,5,29,8,21,0.275862069,,,
Government of Arunachal Pradesh,2018,6,35,14,21,0.4,,,
Government of Arunachal Pradesh,2018,7,23,5,18,0.217391304,,,
Government of Arunachal Pradesh,2018,8,25,4,21,0.16,,,
Government of Arunachal Pradesh,2018,9,29,3,26,0.103448276,,,
Government of Arunachal Pradesh,2018,10,47,23,24,0.489361702,,,
Government of Arunachal Pradesh,2018,11,26,4,22,0.153846154,,,
Government of Arunachal Pradesh,2018,12,26,8,18,0.307692308,,,
Government of Arunachal Pradesh,2019,1,43,15,28,0.348837209,,,
Government of Arunachal Pradesh,2019,2,45,6,39,0.133333333,,,
Government of Arunachal Pradesh,2019,3,53,3,50,0.056603774,,,
Government of Arunachal Pradesh,2019,4,13,2,11,0.153846154,,,
Government of Arunachal Pradesh,2019,5,17,39,-22,2.294117647,,,
Government of Arunachal Pradesh,2019,6,25,5,20,0.2,,,
Government of Arunachal Pradesh,2019,7,20,6,14,0.3,,,
Government of Arunachal Pradesh,2019,8,28,3,25,0.107142857,,,
Government of Arunachal Pradesh,2019,9,59,9,50,0.152542373,,,
Government of Arunachal Pradesh,2019,10,48,7,41,0.145833333,,,
Government of Assam,2016,1,287,1,286,0.003484321,,,
Government of Assam,2016,2,398,2,396,0.005025126,,,
Government of Assam,2016,3,375,1,374,0.002666667,,,
Government of Assam,2016,4,344,3,341,0.00872093,,,
Government of Assam,2016,5,492,5,487,0.010162602,,,
Government of Assam,2016,6,741,9,732,0.012145749,,,
Government of Assam,2016,7,676,11,665,0.016272189,,,
Government of Assam,2016,8,551,2,549,0.003629764,,,
Government of Assam,2016,9,553,5,548,0.009041591,,,
Government of Assam,2016,10,339,5,334,0.014749263,,,
Government of Assam,2016,11,442,25,417,0.056561086,,,
Government of Assam,2016,12,626,77,549,0.123003195,,,
Government of Assam,2017,1,465,127,338,0.27311828,,,
Government of Assam,2017,2,545,114,431,0.209174312,,,
Government of Assam,2017,3,776,47,729,0.06056701,,,
Government of Assam,2017,4,675,19,656,0.028148148,,,
Government of Assam,2017,5,867,42,825,0.048442907,,,
Government of Assam,2017,6,873,33,840,0.037800687,,,
Government of Assam,2017,7,699,74,625,0.105865522,,,
Government of Assam,2017,8,801,41,760,0.051186017,,,
Government of Assam,2017,9,593,49,544,0.082630691,,,
Government of Assam,2017,10,423,52,371,0.122931442,,,
Government of Assam,2017,11,468,98,370,0.209401709,,,
Government of Assam,2017,12,386,36,350,0.093264249,,,
Government of Assam,2018,1,454,45,409,0.099118943,,,
Government of Assam,2018,2,393,60,333,0.152671756,,,
Government of Assam,2018,3,493,66,427,0.133874239,,,
Government of Assam,2018,4,506,52,454,0.102766798,,,
Government of Assam,2018,5,666,78,588,0.117117117,,,
Government of Assam,2018,6,872,71,801,0.081422018,,,
Government of Assam,2018,7,769,147,622,0.191157347,,,
Government of Assam,2018,8,648,175,473,0.270061728,,,
Government of Assam,2018,9,632,153,479,0.242088608,,,
Government of Assam,2018,10,552,72,480,0.130434783,,,
Government of Assam,2018,11,396,74,322,0.186868687,,,
Government of Assam,2018,12,473,99,374,0.209302326,,,
Government of Assam,2019,1,547,63,484,0.115173675,,,
Government of Assam,2019,2,567,239,328,0.421516755,,,
Government of Assam,2019,3,671,189,482,0.281669151,,,
Government of Assam,2019,4,395,108,287,0.273417722,,,
Government of Assam,2019,5,454,233,221,0.513215859,,,
Government of Assam,2019,6,1033,118,915,0.114230397,,,
Government of Assam,2019,7,965,138,827,0.143005181,,,
Government of Assam,2019,8,651,36,615,0.055299539,,,
Government of Assam,2019,9,861,153,708,0.177700348,,,
Government of Assam,2019,10,658,52,606,0.079027356,,,
Government of Assam,2019,11,26,3,23,0.115384615,,,
Government of Bihar,2016,1,799,45,754,0.056320401,,,
Government of Bihar,2016,2,988,98,890,0.099190283,,,
Government of Bihar,2016,3,952,193,759,0.202731092,,,
Government of Bihar,2016,4,855,270,585,0.315789474,,,
Government of Bihar,2016,5,1006,259,747,0.257455268,,,
Government of Bihar,2016,6,1200,336,864,0.28,,,
Government of Bihar,2016,7,1019,246,773,0.24141315,,,
Government of Bihar,2016,8,1303,299,1004,0.229470453,,,
Government of Bihar,2016,9,1299,269,1030,0.207082371,,,
Government of Bihar,2016,10,1114,217,897,0.194793537,,,
Government of Bihar,2016,11,961,206,755,0.214360042,,,
Government of Bihar,2016,12,1477,315,1162,0.213270142,,,
Government of Bihar,2017,1,1358,287,1071,0.211340206,,,
Government of Bihar,2017,2,1265,271,994,0.214229249,,,
Government of Bihar,2017,3,1393,289,1104,0.207465901,,,
Government of Bihar,2017,4,1591,289,1302,0.181646763,,,
Government of Bihar,2017,5,1589,256,1333,0.161107615,,,
Government of Bihar,2017,6,1417,262,1155,0.184897671,,,
Government of Bihar,2017,7,1415,658,757,0.465017668,,,
Government of Bihar,2017,8,1754,663,1091,0.377993158,,,
Government of Bihar,2017,9,1669,723,946,0.433193529,,,
Government of Bihar,2017,10,1602,260,1342,0.162297129,,,
Government of Bihar,2017,11,1709,499,1210,0.291983616,,,
Government of Bihar,2017,12,1644,525,1119,0.319343066,,,
Government of Bihar,2018,1,1505,537,968,0.356810631,,,
Government of Bihar,2018,2,1421,222,1199,0.156228008,,,
Government of Bihar,2018,3,1654,314,1340,0.189842805,,,
Government of Bihar,2018,4,1798,242,1556,0.134593993,,,
Government of Bihar,2018,5,2192,518,1674,0.236313869,,,
Government of Bihar,2018,6,2067,759,1308,0.367198839,,,
Government of Bihar,2018,7,2417,1147,1270,0.474555234,,,
Government of Bihar,2018,8,1898,777,1121,0.409378293,,,
Government of Bihar,2018,9,1994,631,1363,0.316449348,,,
Government of Bihar,2018,10,2087,1383,704,0.662673694,,,
Government of Bihar,2018,11,1718,674,1044,0.392316647,,,
Government of Bihar,2018,12,1828,781,1047,0.427242888,,,
Government of Bihar,2019,1,2118,1096,1022,0.517469311,,,
Government of Bihar,2019,2,2278,1190,1088,0.52238806,,,
Government of Bihar,2019,3,2148,631,1517,0.293761639,,,
Government of Bihar,2019,4,1926,781,1145,0.405503634,,,
Government of Bihar,2019,5,1930,701,1229,0.363212435,,,
Government of Bihar,2019,6,3008,1019,1989,0.338763298,,,
Government of Bihar,2019,7,3865,1492,2373,0.386028461,,,
Government of Bihar,2019,8,3068,1072,1996,0.349413299,,,
Government of Bihar,2019,9,4489,1019,3470,0.226999332,,,
Government of Bihar,2019,10,3457,860,2597,0.24877061,,,
Government of Bihar,2019,11,144,39,105,0.270833333,,,
Government of Chattisgarh,2016,1,268,160,108,0.597014925,,,
Government of Chattisgarh,2016,2,421,150,271,0.356294537,,,
Government of Chattisgarh,2016,3,449,355,94,0.79064588,,,
Government of Chattisgarh,2016,4,426,516,-90,1.211267606,,,
Government of Chattisgarh,2016,5,435,286,149,0.657471264,,,
Government of Chattisgarh,2016,6,591,242,349,0.409475465,,,
Government of Chattisgarh,2016,7,520,652,-132,1.253846154,,,
Government of Chattisgarh,2016,8,591,516,75,0.873096447,,,
Government of Chattisgarh,2016,9,686,523,163,0.762390671,,,
Government of Chattisgarh,2016,10,625,491,134,0.7856,,,
Government of Chattisgarh,2016,11,556,263,293,0.473021583,,,
Government of Chattisgarh,2016,12,706,857,-151,1.21388102,,,
Government of Chattisgarh,2017,1,790,530,260,0.670886076,,,
Government of Chattisgarh,2017,2,794,841,-47,1.059193955,,,
Government of Chattisgarh,2017,3,800,324,476,0.405,,,
Government of Chattisgarh,2017,4,921,764,157,0.829533116,,,
Government of Chattisgarh,2017,5,1120,1283,-163,1.145535714,,,
Government of Chattisgarh,2017,6,826,613,213,0.742130751,,,
Government of Chattisgarh,2017,7,830,321,509,0.386746988,,,
Government of Chattisgarh,2017,8,1020,780,240,0.764705882,,,
Government of Chattisgarh,2017,9,1037,929,108,0.895853423,,,
Government of Chattisgarh,2017,10,767,1234,-467,1.608865711,,,
Government of Chattisgarh,2017,11,815,717,98,0.879754601,,,
Government of Chattisgarh,2017,12,773,666,107,0.861578266,,,
Government of Chattisgarh,2018,1,858,690,168,0.804195804,,,
Government of Chattisgarh,2018,2,771,36,735,0.046692607,,,
Government of Chattisgarh,2018,3,947,588,359,0.620908131,,,
Government of Chattisgarh,2018,4,1106,1979,-873,1.789330922,,,
Government of Chattisgarh,2018,5,1050,849,201,0.808571429,,,
Government of Chattisgarh,2018,6,1066,433,633,0.40619137,,,
Government of Chattisgarh,2018,7,1292,1019,273,0.78869969,,,
Government of Chattisgarh,2018,8,1239,755,484,0.609362389,,,
Government of Chattisgarh,2018,9,1120,1039,81,0.927678571,,,
Government of Chattisgarh,2018,10,1182,948,234,0.802030457,,,
Government of Chattisgarh,2018,11,525,610,-85,1.161904762,,,
Government of Chattisgarh,2018,12,555,539,16,0.971171171,,,
Government of Chattisgarh,2019,1,657,485,172,0.738203957,,,
Government of Chattisgarh,2019,2,820,923,-103,1.125609756,,,
Government of Chattisgarh,2019,3,621,726,-105,1.169082126,,,
Government of Chattisgarh,2019,4,446,404,42,0.905829596,,,
Government of Chattisgarh,2019,5,456,604,-148,1.324561404,,,
Government of Chattisgarh,2019,6,940,756,184,0.804255319,,,
Government of Chattisgarh,2019,7,1047,1048,-1,1.00095511,,,
Government of Chattisgarh,2019,8,909,971,-62,1.068206821,,,
Government of Chattisgarh,2019,9,1245,957,288,0.768674699,,,
Government of Chattisgarh,2019,10,1048,778,270,0.742366412,,,
Government of Chattisgarh,2019,11,38,1,37,0.026315789,,,
Government of Goa,2016,2,78,2,76,0.025641026,,,
Government of Goa,2016,3,67,9,58,0.134328358,,,
Government of Goa,2016,4,50,8,42,0.16,,,
Government of Goa,2016,5,47,11,36,0.234042553,,,
Government of Goa,2016,6,86,9,77,0.104651163,,,
Government of Goa,2016,7,65,64,1,0.984615385,,,
Government of Goa,2016,8,90,54,36,0.6,,,
Government of Goa,2016,9,76,89,-13,1.171052632,,,
Government of Goa,2016,10,76,70,6,0.921052632,,,
Government of Goa,2016,11,97,19,78,0.195876289,,,
Government of Goa,2016,12,137,11,126,0.080291971,,,
Government of Goa,2017,1,108,88,20,0.814814815,,,
Government of Goa,2017,2,91,132,-41,1.450549451,,,
Government of Goa,2017,3,109,46,63,0.422018349,,,
Government of Goa,2017,4,141,68,73,0.482269504,,,
Government of Goa,2017,5,98,109,-11,1.112244898,,,
Government of Goa,2017,6,116,63,53,0.543103448,,,
Government of Goa,2017,7,99,54,45,0.545454545,,,
Government of Goa,2017,8,97,12,85,0.12371134,,,
Government of Goa,2017,9,118,46,72,0.389830508,,,
Government of Goa,2017,10,68,69,-1,1.014705882,,,
Government of Goa,2017,11,88,168,-80,1.909090909,,,
Government of Goa,2017,12,70,43,27,0.614285714,,,
Government of Goa,2018,1,55,79,-24,1.436363636,,,
Government of Goa,2018,2,53,11,42,0.20754717,,,
Government of Goa,2018,3,98,65,33,0.663265306,,,
Government of Goa,2018,4,75,87,-12,1.16,,,
Government of Goa,2018,5,98,28,70,0.285714286,,,
Government of Goa,2018,6,70,41,29,0.585714286,,,
Government of Goa,2018,7,159,56,103,0.352201258,,,
Government of Goa,2018,8,65,41,24,0.630769231,,,
Government of Goa,2018,9,88,118,-30,1.340909091,,,
Government of Goa,2018,10,114,131,-17,1.149122807,,,
Government of Goa,2018,11,56,65,-9,1.160714286,,,
Government of Goa,2018,12,55,27,28,0.490909091,,,
Government of Goa,2019,1,195,95,100,0.487179487,,,
Government of Goa,2019,2,252,326,-74,1.293650794,,,
Government of Goa,2019,3,88,35,53,0.397727273,,,
Government of Goa,2019,4,48,19,29,0.395833333,,,
Government of Goa,2019,5,65,30,35,0.461538462,,,
Government of Goa,2019,6,121,22,99,0.181818182,,,
Government of Goa,2019,7,152,97,55,0.638157895,,,
Government of Goa,2019,8,97,61,36,0.628865979,,,
Government of Goa,2019,9,107,69,38,0.644859813,,,
Government of Goa,2019,10,96,139,-43,1.447916667,,,
Government of Gujarat,2016,1,686,1,685,0.001457726,,,
Government of Gujarat,2016,2,985,15,970,0.015228426,,,
Government of Gujarat,2016,3,1010,15,995,0.014851485,,,
Government of Gujarat,2016,4,960,5,955,0.005208333,,,
Government of Gujarat,2016,5,1069,29,1040,0.027128157,,,
Government of Gujarat,2016,6,1322,21,1301,0.015885023,,,
Government of Gujarat,2016,7,1328,128,1200,0.096385542,,,
Government of Gujarat,2016,8,1244,447,797,0.359324759,,,
Government of Gujarat,2016,9,1252,1093,159,0.873003195,,,
Government of Gujarat,2016,10,1072,537,535,0.500932836,,,
Government of Gujarat,2016,11,1121,349,772,0.31132917,,,
Government of Gujarat,2016,12,1643,769,874,0.468046257,,,
Government of Gujarat,2017,1,1533,669,864,0.436399217,,,
Government of Gujarat,2017,2,1551,838,713,0.540296583,,,
Government of Gujarat,2017,3,2089,607,1482,0.290569651,,,
Government of Gujarat,2017,4,1594,519,1075,0.325595985,,,
Government of Gujarat,2017,5,1998,689,1309,0.344844845,,,
Government of Gujarat,2017,6,2193,2529,-336,1.153214774,,,
Government of Gujarat,2017,7,1833,2532,-699,1.381342062,,,
Government of Gujarat,2017,8,2092,1892,200,0.904397706,,,
Government of Gujarat,2017,9,1896,3365,-1469,1.77478903,,,
Government of Gujarat,2017,10,1688,1830,-142,1.084123223,,,
Government of Gujarat,2017,11,1938,1683,255,0.868421053,,,
Government of Gujarat,2017,12,1516,1225,291,0.808047493,,,
Government of Gujarat,2018,1,1951,1747,204,0.895438237,,,
Government of Gujarat,2018,2,1400,946,454,0.675714286,,,
Government of Gujarat,2018,3,2145,1162,983,0.541724942,,,
Government of Gujarat,2018,4,1918,1872,46,0.976016684,,,
Government of Gujarat,2018,5,2196,1293,903,0.588797814,,,
Government of Gujarat,2018,6,1683,1221,462,0.725490196,,,
Government of Gujarat,2018,7,2304,8610,-6306,3.736979167,,,
Government of Gujarat,2018,8,2014,5227,-3213,2.595332671,,,
Government of Gujarat,2018,9,2297,2739,-442,1.192424902,,,
Government of Gujarat,2018,10,2303,3212,-909,1.394702562,,,
Government of Gujarat,2018,11,1656,2787,-1131,1.682971014,,,
Government of Gujarat,2018,12,1939,2421,-482,1.248581743,,,
Government of Gujarat,2019,1,2501,1969,532,0.787285086,,,
Government of Gujarat,2019,2,2803,2154,649,0.768462362,,,
Government of Gujarat,2019,3,2874,2446,428,0.851078636,,,
Government of Gujarat,2019,4,2131,2132,-1,1.000469263,,,
Government of Gujarat,2019,5,2453,2711,-258,1.105177334,,,
Government of Gujarat,2019,6,3275,1589,1686,0.48519084,,,
Government of Gujarat,2019,7,3553,2614,939,0.735716296,,,
Government of Gujarat,2019,8,2824,2960,-136,1.04815864,,,
Government of Gujarat,2019,9,4178,3524,654,0.843465773,,,
Government of Gujarat,2019,10,3954,3131,823,0.791856348,,,
Government of Gujarat,2019,11,76,31,45,0.407894737,,,
Government of Haryana,2016,1,857,1,856,0.001166861,,,
Government of Haryana,2016,2,1221,10,1211,0.008190008,,,
Government of Haryana,2016,3,1217,3,1214,0.002465078,,,
Government of Haryana,2016,5,1571,7,1564,0.004455761,,,
Government of Haryana,2016,6,1712,7,1705,0.004088785,,,
Government of Haryana,2016,7,1707,5,1702,0.002929115,,,
Government of Haryana,2016,8,1893,6,1887,0.003169572,,,
Government of Haryana,2016,9,1857,7,1850,0.003769521,,,
Government of Haryana,2016,10,1535,5,1530,0.003257329,,,
Government of Haryana,2016,11,1381,15,1366,0.010861694,,,
Government of Haryana,2016,12,1879,79,1800,0.04204364,,,
Government of Haryana,2017,1,1728,201,1527,0.116319444,,,
Government of Haryana,2017,2,1733,136,1597,0.07847663,,,
Government of Haryana,2017,3,2065,46,2019,0.022276029,,,
Government of Haryana,2017,4,2564,36,2528,0.014040562,,,
Government of Haryana,2017,5,2607,28,2579,0.010740315,,,
Government of Haryana,2017,6,2293,24,2269,0.010466638,,,
Government of Haryana,2017,7,2093,28,2065,0.013377926,,,
Government of Haryana,2017,8,2295,4,2291,0.001742919,,,
Government of Haryana,2017,9,2446,11,2435,0.004497138,,,
Government of Haryana,2017,10,1909,1,1908,0.000523834,,,
Government of Haryana,2017,11,1856,49,1807,0.026400862,,,
Government of Haryana,2017,12,1809,96,1713,0.053067993,,,
Government of Haryana,2018,1,1898,65,1833,0.034246575,,,
Government of Haryana,2018,2,1762,90,1672,0.05107832,,,
Government of Haryana,2018,3,2043,84,1959,0.041116006,,,
Government of Haryana,2018,4,2082,198,1884,0.095100865,,,
Government of Haryana,2018,5,2512,97,2415,0.03861465,,,
Government of Haryana,2018,6,2255,589,1666,0.261197339,,,
Government of Haryana,2018,7,2765,11070,-8305,4.003616637,,,
Government of Haryana,2018,8,2316,1676,640,0.723661485,,,
Government of Haryana,2018,9,2253,2926,-673,1.298712827,,,
Government of Haryana,2018,10,2380,3145,-765,1.321428571,,,
Government of Haryana,2018,11,1708,2950,-1242,1.727166276,,,
Government of Haryana,2018,12,1920,2708,-788,1.410416667,,,
Government of Haryana,2019,1,2165,2398,-233,1.107621247,,,
Government of Haryana,2019,2,2238,2440,-202,1.09025916,,,
Government of Haryana,2019,3,2136,3338,-1202,1.562734082,,,
Government of Haryana,2019,4,2014,3906,-1892,1.939424032,,,
Government of Haryana,2019,5,2085,2902,-817,1.391846523,,,
Government of Haryana,2019,6,3381,2258,1123,0.667849749,,,
Government of Haryana,2019,7,3559,3416,143,0.959820174,,,
Government of Haryana,2019,8,2778,3231,-453,1.163066955,,,
Government of Haryana,2019,9,3512,3875,-363,1.103359909,,,
Government of Haryana,2019,10,2589,3610,-1021,1.394360757,,,
Government of Haryana,2019,11,87,2,85,0.022988506,,,
Government of Himachal Pradesh,2016,6,283,1,282,0.003533569,,,
Government of Himachal Pradesh,2016,7,274,2,272,0.00729927,,,
Government of Himachal Pradesh,2016,9,309,1,308,0.003236246,,,
Government of Himachal Pradesh,2016,10,318,1,317,0.003144654,,,
Government of Himachal Pradesh,2016,12,436,1,435,0.002293578,,,
Government of Himachal Pradesh,2017,2,361,1,360,0.002770083,,,
Government of Himachal Pradesh,2017,3,426,1,425,0.002347418,,,
Government of Himachal Pradesh,2017,4,436,1,435,0.002293578,,,
Government of Himachal Pradesh,2017,6,365,1,364,0.002739726,,,
Government of Himachal Pradesh,2017,8,390,1,389,0.002564103,,,
Government of Himachal Pradesh,2017,11,236,2,234,0.008474576,,,
Government of Himachal Pradesh,2017,12,269,1,268,0.003717472,,,
Government of Himachal Pradesh,2018,3,347,1,346,0.002881844,,,
Government of Himachal Pradesh,2018,4,330,1,329,0.003030303,,,
Government of Himachal Pradesh,2018,5,441,5,436,0.011337868,,,
Government of Himachal Pradesh,2018,6,423,8,415,0.01891253,,,
Government of Himachal Pradesh,2018,7,448,26,422,0.058035714,,,
Government of Himachal Pradesh,2018,8,386,17,369,0.044041451,,,
Government of Himachal Pradesh,2018,9,359,11,348,0.030640669,,,
Government of Himachal Pradesh,2018,10,372,8,364,0.021505376,,,
Government of Himachal Pradesh,2018,11,265,14,251,0.052830189,,,
Government of Himachal Pradesh,2018,12,323,10,313,0.030959752,,,
Government of Himachal Pradesh,2019,1,356,15,341,0.042134831,,,
Government of Himachal Pradesh,2019,2,346,188,158,0.543352601,,,
Government of Himachal Pradesh,2019,3,388,6,382,0.015463918,,,
Government of Himachal Pradesh,2019,4,269,6,263,0.022304833,,,
Government of Himachal Pradesh,2019,5,237,5,232,0.021097046,,,
Government of Himachal Pradesh,2019,6,617,11,606,0.017828201,,,
Government of Himachal Pradesh,2019,7,710,9,701,0.012676056,,,
Government of Himachal Pradesh,2019,8,525,9,516,0.017142857,,,
Government of Himachal Pradesh,2019,9,737,18,719,0.024423338,,,
Government of Himachal Pradesh,2019,10,516,21,495,0.040697674,,,
Government of Jammu and Kashmir,2016,1,136,1,135,0.007352941,,,
Government of Jammu and Kashmir,2016,3,174,2,172,0.011494253,,,
Government of Jammu and Kashmir,2016,4,199,1,198,0.005025126,,,
Government of Jammu and Kashmir,2016,6,252,2,250,0.007936508,,,
Government of Jammu and Kashmir,2016,10,219,1,218,0.00456621,,,
Government of Jammu and Kashmir,2016,11,256,1,255,0.00390625,,,
Government of Jammu and Kashmir,2016,12,343,2,341,0.005830904,,,
Government of Jammu and Kashmir,2017,1,298,1,297,0.003355705,,,
Government of Jammu and Kashmir,2017,3,335,1,334,0.002985075,,,
Government of Jammu and Kashmir,2017,4,340,1,339,0.002941176,,,
Government of Jammu and Kashmir,2017,7,284,2,282,0.007042254,,,
Government of Jammu and Kashmir,2017,8,350,3,347,0.008571429,,,
Government of Jammu and Kashmir,2017,10,263,1,262,0.003802281,,,
Government of Jammu and Kashmir,2017,11,256,4,252,0.015625,,,
Government of Jammu and Kashmir,2017,12,216,3,213,0.013888889,,,
Government of Jammu and Kashmir,2018,1,245,1,244,0.004081633,,,
Government of Jammu and Kashmir,2018,2,210,1,209,0.004761905,,,
Government of Jammu and Kashmir,2018,3,255,1,254,0.003921569,,,
Government of Jammu and Kashmir,2018,4,297,1,296,0.003367003,,,
Government of Jammu and Kashmir,2018,5,344,9,335,0.026162791,,,
Government of Jammu and Kashmir,2018,6,283,6,277,0.021201413,,,
Government of Jammu and Kashmir,2018,7,371,36,335,0.09703504,,,
Government of Jammu and Kashmir,2018,8,275,25,250,0.090909091,,,
Government of Jammu and Kashmir,2018,9,277,15,262,0.054151625,,,
Government of Jammu and Kashmir,2018,10,261,20,241,0.076628352,,,
Government of Jammu and Kashmir,2018,11,221,19,202,0.085972851,,,
Government of Jammu and Kashmir,2018,12,260,10,250,0.038461538,,,
Government of Jammu and Kashmir,2019,1,271,11,260,0.040590406,,,
Government of Jammu and Kashmir,2019,2,282,351,-69,1.244680851,,,
Government of Jammu and Kashmir,2019,3,301,14,287,0.046511628,,,
Government of Jammu and Kashmir,2019,4,218,15,203,0.068807339,,,
Government of Jammu and Kashmir,2019,5,233,10,223,0.042918455,,,
Government of Jammu and Kashmir,2019,6,415,12,403,0.028915663,,,
Government of Jammu and Kashmir,2019,7,491,13,478,0.026476578,,,
Government of Jammu and Kashmir,2019,8,296,14,282,0.047297297,,,
Government of Jammu and Kashmir,2019,9,330,6,324,0.018181818,,,
Government of Jammu and Kashmir,2019,10,264,18,246,0.068181818,,,
Government of Jammu and Kashmir,2019,11,11,1,10,0.090909091,,,
Government of Jharkhand,2016,1,417,1,416,0.002398082,,,
Government of Jharkhand,2016,2,494,1,493,0.002024291,,,
Government of Jharkhand,2016,3,449,2,447,0.004454343,,,
Government of Jharkhand,2016,4,458,3,455,0.006550218,,,
Government of Jharkhand,2016,5,469,2,467,0.004264392,,,
Government of Jharkhand,2016,6,582,8,574,0.013745704,,,
Government of Jharkhand,2016,7,473,3,470,0.006342495,,,
Government of Jharkhand,2016,8,580,2,578,0.003448276,,,
Government of Jharkhand,2016,9,570,1,569,0.001754386,,,
Government of Jharkhand,2016,10,531,2,529,0.003766478,,,
Government of Jharkhand,2016,11,481,2,479,0.004158004,,,
Government of Jharkhand,2016,12,868,1,867,0.001152074,,,
Government of Jharkhand,2017,1,707,14,693,0.01980198,,,
Government of Jharkhand,2017,2,810,39,771,0.048148148,,,
Government of Jharkhand,2017,3,885,54,831,0.061016949,,,
Government of Jharkhand,2017,4,1313,54,1259,0.04112719,,,
Government of Jharkhand,2017,5,945,22,923,0.023280423,,,
Government of Jharkhand,2017,6,940,54,886,0.057446809,,,
Government of Jharkhand,2017,7,834,297,537,0.356115108,,,
Government of Jharkhand,2017,8,1123,198,925,0.176313446,,,
Government of Jharkhand,2017,9,989,334,655,0.337714863,,,
Government of Jharkhand,2017,10,732,1265,-533,1.728142077,,,
Government of Jharkhand,2017,11,853,2162,-1309,2.534583822,,,
Government of Jharkhand,2017,12,895,2035,-1140,2.273743017,,,
Government of Jharkhand,2018,1,904,1929,-1025,2.133849558,,,
Government of Jharkhand,2018,2,834,1785,-951,2.14028777,,,
Government of Jharkhand,2018,3,888,1215,-327,1.368243243,,,
Government of Jharkhand,2018,4,778,835,-57,1.073264781,,,
Government of Jharkhand,2018,5,992,519,473,0.523185484,,,
Government of Jharkhand,2018,6,1260,309,951,0.245238095,,,
Government of Jharkhand,2018,7,1357,313,1044,0.230655859,,,
Government of Jharkhand,2018,8,1134,169,965,0.149029982,,,
Government of Jharkhand,2018,9,1078,177,901,0.16419295,,,
Government of Jharkhand,2018,10,1075,62,1013,0.057674419,,,
Government of Jharkhand,2018,11,729,71,658,0.09739369,,,
Government of Jharkhand,2018,12,1017,87,930,0.085545723,,,
Government of Jharkhand,2019,1,897,115,782,0.128205128,,,
Government of Jharkhand,2019,2,887,301,586,0.33934611,,,
Government of Jharkhand,2019,3,824,59,765,0.071601942,,,
Government of Jharkhand,2019,4,650,47,603,0.072307692,,,
Government of Jharkhand,2019,5,734,40,694,0.054495913,,,
Government of Jharkhand,2019,6,1289,41,1248,0.031807603,,,
Government of Jharkhand,2019,7,1347,87,1260,0.064587973,,,
Government of Jharkhand,2019,8,1049,85,964,0.081029552,,,
Government of Jharkhand,2019,9,1433,48,1385,0.033496162,,,
Government of Jharkhand,2019,10,1164,35,1129,0.030068729,,,
Government of Jharkhand,2019,11,44,3,41,0.068181818,,,
Government of Karnataka,2016,1,536,1,535,0.001865672,,,
Government of Karnataka,2016,2,833,5,828,0.006002401,,,
Government of Karnataka,2016,3,1151,8,1143,0.006950478,,,
Government of Karnataka,2016,4,987,4,983,0.004052685,,,
Government of Karnataka,2016,5,956,2,954,0.00209205,,,
Government of Karnataka,2016,6,1232,2,1230,0.001623377,,,
Government of Karnataka,2016,7,1066,4,1062,0.003752345,,,
Government of Karnataka,2016,8,1321,3,1318,0.002271007,,,
Government of Karnataka,2016,9,1195,6,1189,0.005020921,,,
Government of Karnataka,2016,10,921,8,913,0.008686211,,,
Government of Karnataka,2016,11,1163,3,1160,0.002579536,,,
Government of Karnataka,2016,12,2318,222,2096,0.095772217,,,
Government of Karnataka,2017,1,1650,191,1459,0.115757576,,,
Government of Karnataka,2017,2,1494,2138,-644,1.431057564,,,
Government of Karnataka,2017,3,2052,3567,-1515,1.738304094,,,
Government of Karnataka,2017,4,1667,2426,-759,1.455308938,,,
Government of Karnataka,2017,5,1692,1640,52,0.969267139,,,
Government of Karnataka,2017,6,1873,1646,227,0.878804058,,,
Government of Karnataka,2017,7,1920,758,1162,0.394791667,,,
Government of Karnataka,2017,8,1872,1126,746,0.601495726,,,
Government of Karnataka,2017,9,1260,656,604,0.520634921,,,
Government of Karnataka,2017,10,1126,788,338,0.69982238,,,
Government of Karnataka,2017,11,1100,753,347,0.684545455,,,
Government of Karnataka,2017,12,919,423,496,0.460282916,,,
Government of Karnataka,2018,1,1113,2807,-1694,2.522012579,,,
Government of Karnataka,2018,2,1112,2565,-1453,2.306654676,,,
Government of Karnataka,2018,3,1536,2344,-808,1.526041667,,,
Government of Karnataka,2018,4,1220,835,385,0.68442623,,,
Government of Karnataka,2018,5,1577,1214,363,0.769816107,,,
Government of Karnataka,2018,6,1684,1182,502,0.701900238,,,
Government of Karnataka,2018,7,2473,1186,1287,0.479579458,,,
Government of Karnataka,2018,8,1928,1450,478,0.752074689,,,
Government of Karnataka,2018,9,1467,491,976,0.33469666,,,
Government of Karnataka,2018,10,1378,206,1172,0.149492017,,,
Government of Karnataka,2018,11,1105,153,952,0.138461538,,,
Government of Karnataka,2018,12,1143,123,1020,0.107611549,,,
Government of Karnataka,2019,1,1454,231,1223,0.158872077,,,
Government of Karnataka,2019,2,1338,181,1157,0.135276532,,,
Government of Karnataka,2019,3,1506,72,1434,0.047808765,,,
Government of Karnataka,2019,4,1174,96,1078,0.081771721,,,
Government of Karnataka,2019,5,1008,67,941,0.066468254,,,
Government of Karnataka,2019,6,2731,68,2663,0.024899304,,,
Government of Karnataka,2019,7,3269,107,3162,0.032731722,,,
Government of Karnataka,2019,8,2151,86,2065,0.039981404,,,
Government of Karnataka,2019,9,2903,108,2795,0.037202894,,,
Government of Karnataka,2019,10,2635,102,2533,0.038709677,,,
Government of Karnataka,2019,11,85,7,78,0.082352941,,,
Government of Kerala,2016,1,275,2,273,0.007272727,,,
Government of Kerala,2016,2,314,22,292,0.070063694,,,
Government of Kerala,2016,3,443,47,396,0.106094808,,,
Government of Kerala,2016,4,422,84,338,0.199052133,,,
Government of Kerala,2016,5,492,121,371,0.245934959,,,
Government of Kerala,2016,6,519,74,445,0.142581888,,,
Government of Kerala,2016,7,500,35,465,0.07,,,
Government of Kerala,2016,8,453,422,31,0.931567329,,,
Government of Kerala,2016,9,404,34,370,0.084158416,,,
Government of Kerala,2016,10,451,208,243,0.461197339,,,
Government of Kerala,2016,11,467,28,439,0.059957173,,,
Government of Kerala,2016,12,630,21,609,0.033333333,,,
Government of Kerala,2017,1,462,13,449,0.028138528,,,
Government of Kerala,2017,2,495,82,413,0.165656566,,,
Government of Kerala,2017,3,619,172,447,0.277867528,,,
Government of Kerala,2017,4,731,68,663,0.093023256,,,
Government of Kerala,2017,5,990,213,777,0.215151515,,,
Government of Kerala,2017,6,1046,13,1033,0.012428298,,,
Government of Kerala,2017,7,897,53,844,0.059085842,,,
Government of Kerala,2017,8,854,67,787,0.078454333,,,
Government of Kerala,2017,9,504,11,493,0.021825397,,,
Government of Kerala,2017,10,560,1,559,0.001785714,,,
Government of Kerala,2017,11,670,3,667,0.004477612,,,
Government of Kerala,2017,12,499,9,490,0.018036072,,,
Government of Kerala,2018,1,561,13,548,0.023172906,,,
Government of Kerala,2018,2,505,2,503,0.003960396,,,
Government of Kerala,2018,3,483,4,479,0.008281573,,,
Government of Kerala,2018,4,519,1,518,0.001926782,,,
Government of Kerala,2018,5,444,28,416,0.063063063,,,
Government of Kerala,2018,6,552,32,520,0.057971014,,,
Government of Kerala,2018,7,562,69,493,0.122775801,,,
Government of Kerala,2018,8,587,75,512,0.127768313,,,
Government of Kerala,2018,9,559,94,465,0.168157424,,,
Government of Kerala,2018,10,521,64,457,0.122840691,,,
Government of Kerala,2018,11,479,48,431,0.100208768,,,
Government of Kerala,2018,12,403,40,363,0.099255583,,,
Government of Kerala,2019,1,562,45,517,0.080071174,,,
Government of Kerala,2019,2,698,444,254,0.636103152,,,
Government of Kerala,2019,3,569,49,520,0.086115993,,,
Government of Kerala,2019,4,319,53,266,0.166144201,,,
Government of Kerala,2019,5,661,47,614,0.071104387,,,
Government of Kerala,2019,6,688,49,639,0.07122093,,,
Government of Kerala,2019,7,717,52,665,0.072524407,,,
Government of Kerala,2019,8,518,62,456,0.11969112,,,
Government of Kerala,2019,9,640,54,586,0.084375,,,
Government of Kerala,2019,10,920,434,486,0.47173913,,,
Government of Kerala,2019,11,49,24,25,0.489795918,,,
Government of Madhya Pradesh,2016,1,1076,12,1064,0.011152416,,,
Government of Madhya Pradesh,2016,2,1281,26,1255,0.020296643,,,
Government of Madhya Pradesh,2016,3,1542,41,1501,0.026588846,,,
Government of Madhya Pradesh,2016,4,1200,66,1134,0.055,,,
Government of Madhya Pradesh,2016,5,1308,19,1289,0.014525994,,,
Government of Madhya Pradesh,2016,6,1749,44,1705,0.025157233,,,
Government of Madhya Pradesh,2016,7,1545,49,1496,0.03171521,,,
Government of Madhya Pradesh,2016,8,1895,58,1837,0.03060686,,,
Government of Madhya Pradesh,2016,9,2114,62,2052,0.029328288,,,
Government of Madhya Pradesh,2016,10,1974,242,1732,0.122593718,,,
Government of Madhya Pradesh,2016,11,1777,293,1484,0.164884637,,,
Government of Madhya Pradesh,2016,12,2560,243,2317,0.094921875,,,
Government of Madhya Pradesh,2017,1,2218,262,1956,0.118124436,,,
Government of Madhya Pradesh,2017,2,2088,260,1828,0.124521073,,,
Government of Madhya Pradesh,2017,3,2381,379,2002,0.159176816,,,
Government of Madhya Pradesh,2017,4,2683,392,2291,0.146105106,,,
Government of Madhya Pradesh,2017,5,2529,167,2362,0.066034006,,,
Government of Madhya Pradesh,2017,6,2222,223,1999,0.100360036,,,
Government of Madhya Pradesh,2017,7,2021,111,1910,0.054923305,,,
Government of Madhya Pradesh,2017,8,2656,52,2604,0.019578313,,,
Government of Madhya Pradesh,2017,9,2518,205,2313,0.08141382,,,
Government of Madhya Pradesh,2017,10,2025,231,1794,0.114074074,,,
Government of Madhya Pradesh,2017,11,2096,165,1931,0.078721374,,,
Government of Madhya Pradesh,2017,12,2201,228,1973,0.103589278,,,
Government of Madhya Pradesh,2018,1,2185,258,1927,0.118077803,,,
Government of Madhya Pradesh,2018,2,1969,161,1808,0.081767395,,,
Government of Madhya Pradesh,2018,3,2394,184,2210,0.076858814,,,
Government of Madhya Pradesh,2018,4,2217,246,1971,0.110960758,,,
Government of Madhya Pradesh,2018,5,2962,557,2405,0.188048616,,,
Government of Madhya Pradesh,2018,6,2742,456,2286,0.166301969,,,
Government of Madhya Pradesh,2018,7,3478,497,2981,0.142898217,,,
Government of Madhya Pradesh,2018,8,2830,399,2431,0.140989399,,,
Government of Madhya Pradesh,2018,9,2837,211,2626,0.074374339,,,
Government of Madhya Pradesh,2018,10,2389,303,2086,0.12683131,,,
Government of Madhya Pradesh,2018,11,1611,317,1294,0.196772191,,,
Government of Madhya Pradesh,2018,12,1574,271,1303,0.172172808,,,
Government of Madhya Pradesh,2019,1,2008,464,1544,0.231075697,,,
Government of Madhya Pradesh,2019,2,2072,1165,907,0.562258687,,,
Government of Madhya Pradesh,2019,3,2299,937,1362,0.407568508,,,
Government of Madhya Pradesh,2019,4,1455,354,1101,0.243298969,,,
Government of Madhya Pradesh,2019,5,1647,426,1221,0.258652095,,,
Government of Madhya Pradesh,2019,6,3192,440,2752,0.137844612,,,
Government of Madhya Pradesh,2019,7,4059,805,3254,0.198324711,,,
Government of Madhya Pradesh,2019,8,3065,556,2509,0.181402936,,,
Government of Madhya Pradesh,2019,9,4210,496,3714,0.117814727,,,
Government of Madhya Pradesh,2019,10,3345,560,2785,0.167414051,,,
Government of Madhya Pradesh,2019,11,171,30,141,0.175438596,,,
Government of Maharashtra,2016,1,1503,1,1502,0.000665336,,,
Government of Maharashtra,2016,2,1831,26,1805,0.014199891,,,
Government of Maharashtra,2016,3,1972,46,1926,0.023326572,,,
Government of Maharashtra,2016,4,2029,130,1899,0.064070971,,,
Government of Maharashtra,2016,5,1955,218,1737,0.111508951,,,
Government of Maharashtra,2016,6,2655,332,2323,0.125047081,,,
Government of Maharashtra,2016,7,2212,201,2011,0.090867993,,,
Government of Maharashtra,2016,8,3147,193,2954,0.061328249,,,
Government of Maharashtra,2016,9,2819,198,2621,0.070237673,,,
Government of Maharashtra,2016,10,2448,448,2000,0.183006536,,,
Government of Maharashtra,2016,11,2583,456,2127,0.176538908,,,
Government of Maharashtra,2016,12,4830,541,4289,0.112008282,,,
Government of Maharashtra,2017,1,3397,326,3071,0.09596703,,,
Government of Maharashtra,2017,2,3126,780,2346,0.249520154,,,
Government of Maharashtra,2017,3,3791,792,2999,0.208915853,,,
Government of Maharashtra,2017,4,3851,1055,2796,0.273954817,,,
Government of Maharashtra,2017,5,3973,1372,2601,0.345330984,,,
Government of Maharashtra,2017,6,4120,1223,2897,0.29684466,,,
Government of Maharashtra,2017,7,3740,1569,2171,0.419518717,,,
Government of Maharashtra,2017,8,4310,1350,2960,0.313225058,,,
Government of Maharashtra,2017,9,3274,2105,1169,0.642944411,,,
Government of Maharashtra,2017,10,2443,1444,999,0.591076545,,,
Government of Maharashtra,2017,11,2781,1747,1034,0.628191298,,,
Government of Maharashtra,2017,12,2322,828,1494,0.356589147,,,
Government of Maharashtra,2018,1,2553,2399,154,0.939678809,,,
Government of Maharashtra,2018,2,2362,1702,660,0.720575783,,,
Government of Maharashtra,2018,3,2732,2477,255,0.906661786,,,
Government of Maharashtra,2018,4,2853,2361,492,0.827549947,,,
Government of Maharashtra,2018,5,3218,2608,610,0.810441268,,,
Government of Maharashtra,2018,6,2755,1769,986,0.642105263,,,
Government of Maharashtra,2018,7,3730,2199,1531,0.589544236,,,
Government of Maharashtra,2018,8,3396,1996,1400,0.587750294,,,
Government of Maharashtra,2018,9,3607,1530,2077,0.424175215,,,
Government of Maharashtra,2018,10,3832,1978,1854,0.516179541,,,
Government of Maharashtra,2018,11,3074,1162,1912,0.378009109,,,
Government of Maharashtra,2018,12,3189,1593,1596,0.499529633,,,
Government of Maharashtra,2019,1,4276,1191,3085,0.278531338,,,
Government of Maharashtra,2019,2,4646,2000,2646,0.43047783,,,
Government of Maharashtra,2019,3,3745,944,2801,0.252069426,,,
Government of Maharashtra,2019,4,3242,803,2439,0.247686613,,,
Government of Maharashtra,2019,5,2980,811,2169,0.272147651,,,
Government of Maharashtra,2019,6,5020,714,4306,0.142231076,,,
Government of Maharashtra,2019,7,5500,1256,4244,0.228363636,,,
Government of Maharashtra,2019,8,4206,1566,2640,0.37232525,,,
Government of Maharashtra,2019,9,6789,889,5900,0.13094712,,,
Government of Maharashtra,2019,10,5450,675,4775,0.123853211,,,
Government of Maharashtra,2019,11,174,28,146,0.16091954,,,
Government of Manipur,2016,3,20,1,19,0.05,,,
Government of Manipur,2016,6,42,1,41,0.023809524,,,
Government of Manipur,2016,7,39,1,38,0.025641026,,,
Government of Manipur,2016,10,72,1,71,0.013888889,,,
Government of Manipur,2017,2,36,1,35,0.027777778,,,
Government of Manipur,2017,3,47,1,46,0.021276596,,,
Government of Manipur,2017,5,37,1,36,0.027027027,,,
Government of Manipur,2017,11,47,1,46,0.021276596,,,
Government of Manipur,2017,12,25,1,24,0.04,,,
Government of Manipur,2018,5,25,1,24,0.04,,,
Government of Manipur,2018,6,24,4,20,0.166666667,,,
Government of Manipur,2018,7,22,1,21,0.045454545,,,
Government of Manipur,2018,8,11,1,10,0.090909091,,,
Government of Manipur,2018,9,18,4,14,0.222222222,,,
Government of Manipur,2018,11,15,2,13,0.133333333,,,
Government of Manipur,2018,12,18,1,17,0.055555556,,,
Government of Manipur,2019,1,19,1,18,0.052631579,,,
Government of Manipur,2019,2,26,32,-6,1.230769231,,,
Government of Manipur,2019,3,15,2,13,0.133333333,,,
Government of Manipur,2019,4,17,2,15,0.117647059,,,
Government of Manipur,2019,5,13,3,10,0.230769231,,,
Government of Manipur,2019,6,24,1,23,0.041666667,,,
Government of Manipur,2019,7,29,1,28,0.034482759,,,
Government of Manipur,2019,8,27,2,25,0.074074074,,,
Government of Manipur,2019,9,39,1,38,0.025641026,,,
Government of Manipur,2019,10,32,1,31,0.03125,,,
Government of Meghalaya,2016,3,10,3,7,0.3,,,
Government of Meghalaya,2016,4,18,7,11,0.388888889,,,
Government of Meghalaya,2016,5,25,5,20,0.2,,,
Government of Meghalaya,2016,6,37,1,36,0.027027027,,,
Government of Meghalaya,2016,7,27,1,26,0.037037037,,,
Government of Meghalaya,2016,8,30,1,29,0.033333333,,,
Government of Meghalaya,2016,11,32,1,31,0.03125,,,
Government of Meghalaya,2017,2,418,2,416,0.004784689,,,
Government of Meghalaya,2017,4,34,2,32,0.058823529,,,
Government of Meghalaya,2017,5,19,13,6,0.684210526,,,
Government of Meghalaya,2017,6,23,5,18,0.217391304,,,
Government of Meghalaya,2017,7,13,2,11,0.153846154,,,
Government of Meghalaya,2017,10,25,2,23,0.08,,,
Government of Meghalaya,2018,4,20,1,19,0.05,,,
Government of Meghalaya,2018,5,25,3,22,0.12,,,
Government of Meghalaya,2018,6,26,3,23,0.115384615,,,
Government of Meghalaya,2018,7,25,6,19,0.24,,,
Government of Meghalaya,2018,8,22,6,16,0.272727273,,,
Government of Meghalaya,2018,9,19,12,7,0.631578947,,,
Government of Meghalaya,2018,10,25,2,23,0.08,,,
Government of Meghalaya,2018,11,11,2,9,0.181818182,,,
Government of Meghalaya,2018,12,13,3,10,0.230769231,,,
Government of Meghalaya,2019,1,13,5,8,0.384615385,,,
Government of Meghalaya,2019,2,10,30,-20,3,,,
Government of Meghalaya,2019,3,27,3,24,0.111111111,,,
Government of Meghalaya,2019,4,25,7,18,0.28,,,
Government of Meghalaya,2019,5,18,19,-1,1.055555556,,,
Government of Meghalaya,2019,6,32,7,25,0.21875,,,
Government of Meghalaya,2019,7,35,8,27,0.228571429,,,
Government of Meghalaya,2019,8,25,5,20,0.2,,,
Government of Meghalaya,2019,9,47,1,46,0.021276596,,,
Government of Meghalaya,2019,10,45,2,43,0.044444444,,,
Government of Mizoram,2016,3,4,1,3,0.25,,,
Government of Mizoram,2016,7,17,1,16,0.058823529,,,
Government of Mizoram,2018,6,7,1,6,0.142857143,,,
Government of Mizoram,2018,7,9,2,7,0.222222222,,,
Government of Mizoram,2018,8,8,2,6,0.25,,,
Government of Mizoram,2018,9,9,1,8,0.111111111,,,
Government of Mizoram,2018,11,7,1,6,0.142857143,,,
Government of Mizoram,2018,12,5,2,3,0.4,,,
Government of Mizoram,2019,1,4,3,1,0.75,,,
Government of Mizoram,2019,2,10,12,-2,1.2,,,
Government of Mizoram,2019,4,4,2,2,0.5,,,
Government of Mizoram,2019,5,8,2,6,0.25,,,
Government of Mizoram,2019,10,19,1,18,0.052631579,,,
Government of Nagaland,2016,3,6,1,5,0.166666667,,,
Government of Nagaland,2016,6,26,1,25,0.038461538,,,
Government of Nagaland,2016,7,26,2,24,0.076923077,,,
Government of Nagaland,2016,9,20,4,16,0.2,,,
Government of Nagaland,2016,10,23,58,-35,2.52173913,,,
Government of Nagaland,2016,11,13,7,6,0.538461538,,,
Government of Nagaland,2016,12,16,2,14,0.125,,,
Government of Nagaland,2017,1,18,3,15,0.166666667,,,
Government of Nagaland,2017,2,13,5,8,0.384615385,,,
Government of Nagaland,2017,3,23,28,-5,1.217391304,,,
Government of Nagaland,2017,4,18,14,4,0.777777778,,,
Government of Nagaland,2017,5,17,15,2,0.882352941,,,
Government of Nagaland,2017,6,14,7,7,0.5,,,
Government of Nagaland,2017,7,18,7,11,0.388888889,,,
Government of Nagaland,2017,8,15,9,6,0.6,,,
Government of Nagaland,2017,9,13,28,-15,2.153846154,,,
Government of Nagaland,2017,10,10,21,-11,2.1,,,
Government of Nagaland,2017,11,13,17,-4,1.307692308,,,
Government of Nagaland,2017,12,9,4,5,0.444444444,,,
Government of Nagaland,2018,1,8,9,-1,1.125,,,
Government of Nagaland,2018,2,13,7,6,0.538461538,,,
Government of Nagaland,2018,3,7,15,-8,2.142857143,,,
Government of Nagaland,2018,4,7,3,4,0.428571429,,,
Government of Nagaland,2018,5,11,8,3,0.727272727,,,
Government of Nagaland,2018,6,7,13,-6,1.857142857,,,
Government of Nagaland,2018,7,9,9,0,1,,,
Government of Nagaland,2018,8,18,10,8,0.555555556,,,
Government of Nagaland,2018,9,10,7,3,0.7,,,
Government of Nagaland,2018,10,14,7,7,0.5,,,
Government of Nagaland,2018,11,8,7,1,0.875,,,
Government of Nagaland,2018,12,6,2,4,0.333333333,,,
Government of Nagaland,2019,1,6,3,3,0.5,,,
Government of Nagaland,2019,2,10,6,4,0.6,,,
Government of Nagaland,2019,3,5,3,2,0.6,,,
Government of Nagaland,2019,4,7,4,3,0.571428571,,,
Government of Nagaland,2019,5,9,3,6,0.333333333,,,
Government of Nagaland,2019,6,11,6,5,0.545454545,,,
Government of Nagaland,2019,7,8,5,3,0.625,,,
Government of Nagaland,2019,8,15,2,13,0.133333333,,,
Government of Nagaland,2019,9,38,8,30,0.210526316,,,
Government of Nagaland,2019,10,24,3,21,0.125,,,
Government of Nagaland,2019,11,2,4,-2,2,,,
Government of NCT of Delhi,2016,1,1132,284,848,0.250883392,,,
Government of NCT of Delhi,2016,2,1548,578,970,0.373385013,,,
Government of NCT of Delhi,2016,3,1691,743,948,0.439384979,,,
Government of NCT of Delhi,2016,4,1593,741,852,0.465160075,,,
Government of NCT of Delhi,2016,5,1806,913,893,0.505537099,,,
Government of NCT of Delhi,2016,6,1775,931,844,0.524507042,,,
Government of NCT of Delhi,2016,7,1691,1799,-108,1.063867534,,,
Government of NCT of Delhi,2016,8,1855,799,1056,0.430727763,,,
Government of NCT of Delhi,2016,9,1876,272,1604,0.144989339,,,
Government of NCT of Delhi,2016,10,1617,215,1402,0.132962276,,,
Government of NCT of Delhi,2016,11,1466,266,1200,0.181446112,,,
Government of NCT of Delhi,2016,12,1778,507,1271,0.285151856,,,
Government of NCT of Delhi,2017,1,1560,372,1188,0.238461538,,,
Government of NCT of Delhi,2017,2,1597,982,615,0.614902943,,,
Government of NCT of Delhi,2017,3,2051,560,1491,0.273037543,,,
Government of NCT of Delhi,2017,4,2042,388,1654,0.190009794,,,
Government of NCT of Delhi,2017,5,2389,2331,58,0.975722059,,,
Government of NCT of Delhi,2017,6,2433,9644,-7211,3.963830662,,,
Government of NCT of Delhi,2017,7,2328,2281,47,0.979810997,,,
Government of NCT of Delhi,2017,8,2360,377,1983,0.159745763,,,
Government of NCT of Delhi,2017,9,2174,197,1977,0.090616375,,,
Government of NCT of Delhi,2017,10,1959,3736,-1777,1.907095457,,,
Government of NCT of Delhi,2017,11,2121,128,1993,0.060348892,,,
Government of NCT of Delhi,2017,12,1794,137,1657,0.076365663,,,
Government of NCT of Delhi,2018,1,1504,2635,-1131,1.751994681,,,
Government of NCT of Delhi,2018,2,1594,9191,-7597,5.765997491,,,
Government of NCT of Delhi,2018,3,1862,200,1662,0.107411386,,,
Government of NCT of Delhi,2018,4,2041,345,1696,0.169034787,,,
Government of NCT of Delhi,2018,5,2535,5624,-3089,2.218540434,,,
Government of NCT of Delhi,2018,6,2269,1354,915,0.596738651,,,
Government of NCT of Delhi,2018,7,3260,2853,407,0.875153374,,,
Government of NCT of Delhi,2018,8,3463,2793,670,0.806526133,,,
Government of NCT of Delhi,2018,9,4825,1171,3654,0.242694301,,,
Government of NCT of Delhi,2018,10,3618,1630,1988,0.450525152,,,
Government of NCT of Delhi,2018,11,1763,6128,-4365,3.475893364,,,
Government of NCT of Delhi,2018,12,1660,3246,-1586,1.955421687,,,
Government of NCT of Delhi,2019,1,1734,1208,526,0.696655133,,,
Government of NCT of Delhi,2019,2,1730,1142,588,0.660115607,,,
Government of NCT of Delhi,2019,3,2530,975,1555,0.385375494,,,
Government of NCT of Delhi,2019,4,2286,4471,-2185,1.955818023,,,
Government of NCT of Delhi,2019,5,2093,3555,-1462,1.698518872,,,
Government of NCT of Delhi,2019,6,2401,273,2128,0.113702624,,,
Government of NCT of Delhi,2019,7,2995,2295,700,0.766277129,,,
Government of NCT of Delhi,2019,8,2883,3219,-336,1.116545265,,,
Government of NCT of Delhi,2019,9,3151,1289,1862,0.409076484,,,
Government of NCT of Delhi,2019,10,3145,1797,1348,0.571383148,,,
Government of NCT of Delhi,2019,11,69,4,65,0.057971014,,,
Government of Odisha,2016,2,441,5,436,0.011337868,,,
Government of Odisha,2016,3,417,4,413,0.009592326,,,
Government of Odisha,2016,4,361,3,358,0.008310249,,,
Government of Odisha,2016,5,362,3,359,0.008287293,,,
Government of Odisha,2016,6,536,9,527,0.016791045,,,
Government of Odisha,2016,7,454,1,453,0.002202643,,,
Government of Odisha,2016,8,948,2,946,0.002109705,,,
Government of Odisha,2016,9,600,1,599,0.001666667,,,
Government of Odisha,2016,10,539,2,537,0.003710575,,,
Government of Odisha,2016,11,583,3,580,0.005145798,,,
Government of Odisha,2016,12,745,3,742,0.004026846,,,
Government of Odisha,2017,1,588,3,585,0.005102041,,,
Government of Odisha,2017,2,538,4,534,0.007434944,,,
Government of Odisha,2017,3,681,5,676,0.007342144,,,
Government of Odisha,2017,4,870,1,869,0.001149425,,,
Government of Odisha,2017,5,850,4,846,0.004705882,,,
Government of Odisha,2017,6,718,22,696,0.030640669,,,
Government of Odisha,2017,7,696,27,669,0.038793103,,,
Government of Odisha,2017,8,684,49,635,0.071637427,,,
Government of Odisha,2017,9,511,17,494,0.033268102,,,
Government of Odisha,2017,10,492,26,466,0.052845528,,,
Government of Odisha,2017,11,571,14,557,0.024518389,,,
Government of Odisha,2017,12,420,13,407,0.030952381,,,
Government of Odisha,2018,1,402,19,383,0.047263682,,,
Government of Odisha,2018,2,358,6,352,0.016759777,,,
Government of Odisha,2018,3,428,18,410,0.042056075,,,
Government of Odisha,2018,4,493,17,476,0.034482759,,,
Government of Odisha,2018,5,540,33,507,0.061111111,,,
Government of Odisha,2018,6,720,55,665,0.076388889,,,
Government of Odisha,2018,7,616,137,479,0.222402597,,,
Government of Odisha,2018,8,530,77,453,0.145283019,,,
Government of Odisha,2018,9,527,38,489,0.072106262,,,
Government of Odisha,2018,10,586,60,526,0.102389078,,,
Government of Odisha,2018,11,433,53,380,0.122401848,,,
Government of Odisha,2018,12,389,48,341,0.123393316,,,
Government of Odisha,2019,1,493,65,428,0.131845842,,,
Government of Odisha,2019,2,532,736,-204,1.383458647,,,
Government of Odisha,2019,3,562,47,515,0.083629893,,,
Government of Odisha,2019,4,401,55,346,0.137157107,,,
Government of Odisha,2019,5,417,62,355,0.148681055,,,
Government of Odisha,2019,6,622,80,542,0.128617363,,,
Government of Odisha,2019,7,840,145,695,0.172619048,,,
Government of Odisha,2019,8,672,77,595,0.114583333,,,
Government of Odisha,2019,9,848,189,659,0.222877358,,,
Government of Odisha,2019,10,719,59,660,0.082058414,,,
Government of Odisha,2019,11,33,12,21,0.363636364,,,
Government of Puducherry,2016,1,22,2,20,0.090909091,,,
Government of Puducherry,2016,2,54,33,21,0.611111111,,,
Government of Puducherry,2016,3,43,20,23,0.465116279,,,
Government of Puducherry,2016,4,43,24,19,0.558139535,,,
Government of Puducherry,2016,5,35,46,-11,1.314285714,,,
Government of Puducherry,2016,6,42,37,5,0.880952381,,,
Government of Puducherry,2016,7,38,21,17,0.552631579,,,
Government of Puducherry,2016,8,48,22,26,0.458333333,,,
Government of Puducherry,2016,9,61,11,50,0.180327869,,,
Government of Puducherry,2016,10,42,46,-4,1.095238095,,,
Government of Puducherry,2016,11,51,35,16,0.68627451,,,
Government of Puducherry,2016,12,62,16,46,0.258064516,,,
Government of Puducherry,2017,1,39,41,-2,1.051282051,,,
Government of Puducherry,2017,2,48,54,-6,1.125,,,
Government of Puducherry,2017,3,67,210,-143,3.134328358,,,
Government of Puducherry,2017,4,49,105,-56,2.142857143,,,
Government of Puducherry,2017,5,45,28,17,0.622222222,,,
Government of Puducherry,2017,6,60,34,26,0.566666667,,,
Government of Puducherry,2017,7,52,39,13,0.75,,,
Government of Puducherry,2017,8,44,38,6,0.863636364,,,
Government of Puducherry,2017,9,45,26,19,0.577777778,,,
Government of Puducherry,2017,10,64,43,21,0.671875,,,
Government of Puducherry,2017,11,42,131,-89,3.119047619,,,
Government of Puducherry,2017,12,46,23,23,0.5,,,
Government of Puducherry,2018,1,39,31,8,0.794871795,,,
Government of Puducherry,2018,2,70,59,11,0.842857143,,,
Government of Puducherry,2018,3,73,30,43,0.410958904,,,
Government of Puducherry,2018,4,41,46,-5,1.12195122,,,
Government of Puducherry,2018,5,68,45,23,0.661764706,,,
Government of Puducherry,2018,6,52,33,19,0.634615385,,,
Government of Puducherry,2018,7,54,42,12,0.777777778,,,
Government of Puducherry,2018,8,71,28,43,0.394366197,,,
Government of Puducherry,2018,9,48,30,18,0.625,,,
Government of Puducherry,2018,10,61,43,18,0.704918033,,,
Government of Puducherry,2018,11,47,34,13,0.723404255,,,
Government of Puducherry,2018,12,77,88,-11,1.142857143,,,
Government of Puducherry,2019,1,69,51,18,0.739130435,,,
Government of Puducherry,2019,2,93,60,33,0.64516129,,,
Government of Puducherry,2019,3,41,39,2,0.951219512,,,
Government of Puducherry,2019,4,35,44,-9,1.257142857,,,
Government of Puducherry,2019,5,52,11,41,0.211538462,,,
Government of Puducherry,2019,6,88,11,77,0.125,,,
Government of Puducherry,2019,7,76,38,38,0.5,,,
Government of Puducherry,2019,8,71,30,41,0.422535211,,,
Government of Puducherry,2019,9,103,34,69,0.330097087,,,
Government of Puducherry,2019,10,107,86,21,0.803738318,,,
Government of Punjab,2016,1,314,10,304,0.031847134,,,
Government of Punjab,2016,2,478,162,316,0.338912134,,,
Government of Punjab,2016,3,478,185,293,0.387029289,,,
Government of Punjab,2016,4,472,331,141,0.701271186,,,
Government of Punjab,2016,5,560,301,259,0.5375,,,
Government of Punjab,2016,6,642,274,368,0.426791277,,,
Government of Punjab,2016,7,572,207,365,0.361888112,,,
Government of Punjab,2016,8,690,209,481,0.302898551,,,
Government of Punjab,2016,9,697,463,234,0.664275466,,,
Government of Punjab,2016,10,597,75,522,0.125628141,,,
Government of Punjab,2016,11,616,34,582,0.055194805,,,
Government of Punjab,2016,12,873,62,811,0.071019473,,,
Government of Punjab,2017,1,707,171,536,0.241867044,,,
Government of Punjab,2017,2,661,85,576,0.128593041,,,
Government of Punjab,2017,3,687,77,610,0.112081514,,,
Government of Punjab,2017,4,801,199,602,0.248439451,,,
Government of Punjab,2017,5,856,3156,-2300,3.686915888,,,
Government of Punjab,2017,6,789,604,185,0.765525982,,,
Government of Punjab,2017,7,832,568,264,0.682692308,,,
Government of Punjab,2017,8,818,464,354,0.567237164,,,
Government of Punjab,2017,9,798,400,398,0.501253133,,,
Government of Punjab,2017,10,710,293,417,0.412676056,,,
Government of Punjab,2017,11,750,260,490,0.346666667,,,
Government of Punjab,2017,12,584,342,242,0.585616438,,,
Government of Punjab,2018,1,702,363,339,0.517094017,,,
Government of Punjab,2018,2,694,295,399,0.425072046,,,
Government of Punjab,2018,3,764,290,474,0.379581152,,,
Government of Punjab,2018,4,713,266,447,0.373071529,,,
Government of Punjab,2018,5,943,586,357,0.621420997,,,
Government of Punjab,2018,6,703,629,74,0.894736842,,,
Government of Punjab,2018,7,1104,689,415,0.624094203,,,
Government of Punjab,2018,8,938,458,480,0.488272921,,,
Government of Punjab,2018,9,812,469,343,0.577586207,,,
Government of Punjab,2018,10,938,417,521,0.4445629,,,
Government of Punjab,2018,11,804,251,553,0.312189055,,,
Government of Punjab,2018,12,808,364,444,0.45049505,,,
Government of Punjab,2019,1,629,641,-12,1.019077901,,,
Government of Punjab,2019,2,817,783,34,0.958384333,,,
Government of Punjab,2019,3,972,393,579,0.404320988,,,
Government of Punjab,2019,4,983,587,396,0.597151577,,,
Government of Punjab,2019,5,705,473,232,0.670921986,,,
Government of Punjab,2019,6,1237,133,1104,0.107518189,,,
Government of Punjab,2019,7,1377,1965,-588,1.427015251,,,
Government of Punjab,2019,8,1074,777,297,0.723463687,,,
Government of Punjab,2019,9,1752,1802,-50,1.028538813,,,
Government of Punjab,2019,10,1172,500,672,0.42662116,,,
Government of Rajasthan,2016,1,1197,3,1194,0.002506266,,,
Government of Rajasthan,2016,3,1710,1,1709,0.000584795,,,
Government of Rajasthan,2016,4,1620,2,1618,0.001234568,,,
Government of Rajasthan,2016,5,1736,5,1731,0.002880184,,,
Government of Rajasthan,2016,6,2540,4,2536,0.001574803,,,
Government of Rajasthan,2016,7,2032,2,2030,0.000984252,,,
Government of Rajasthan,2016,8,2197,5,2192,0.002275831,,,
Government of Rajasthan,2016,9,2401,2,2399,0.000832986,,,
Government of Rajasthan,2016,10,2126,5,2121,0.002351834,,,
Government of Rajasthan,2016,11,1905,3,1902,0.001574803,,,
Government of Rajasthan,2016,12,2999,9,2990,0.003001,,,
Government of Rajasthan,2017,1,2513,3,2510,0.001193792,,,
Government of Rajasthan,2017,2,2509,10,2499,0.003985652,,,
Government of Rajasthan,2017,3,3193,85,3108,0.026620733,,,
Government of Rajasthan,2017,4,3430,55,3375,0.016034985,,,
Government of Rajasthan,2017,5,3359,74,3285,0.022030366,,,
Government of Rajasthan,2017,6,2726,33,2693,0.012105649,,,
Government of Rajasthan,2017,7,2829,48,2781,0.016967126,,,
Government of Rajasthan,2017,8,2983,228,2755,0.076433121,,,
Government of Rajasthan,2017,9,2999,39,2960,0.013004335,,,
Government of Rajasthan,2017,10,2444,59,2385,0.024140753,,,
Government of Rajasthan,2017,11,2476,77,2399,0.031098546,,,
Government of Rajasthan,2017,12,2614,54,2560,0.020657995,,,
Government of Rajasthan,2018,1,2812,74,2738,0.026315789,,,
Government of Rajasthan,2018,2,2678,34,2644,0.012696042,,,
Government of Rajasthan,2018,3,2959,70,2889,0.023656641,,,
Government of Rajasthan,2018,4,2516,75,2441,0.029809221,,,
Government of Rajasthan,2018,5,3379,98,3281,0.029002664,,,
Government of Rajasthan,2018,6,3107,100,3007,0.032185388,,,
Government of Rajasthan,2018,7,3869,253,3616,0.065391574,,,
Government of Rajasthan,2018,8,3233,142,3091,0.043922054,,,
Government of Rajasthan,2018,9,3161,77,3084,0.02435938,,,
Government of Rajasthan,2018,10,2893,104,2789,0.035948842,,,
Government of Rajasthan,2018,11,1626,78,1548,0.04797048,,,
Government of Rajasthan,2018,12,1858,116,1742,0.062432723,,,
Government of Rajasthan,2019,1,2055,764,1291,0.371776156,,,
Government of Rajasthan,2019,2,2219,4332,-2113,1.952230735,,,
Government of Rajasthan,2019,3,2017,198,1819,0.098165592,,,
Government of Rajasthan,2019,4,1780,2346,-566,1.317977528,,,
Government of Rajasthan,2019,5,2008,1625,383,0.809262948,,,
Government of Rajasthan,2019,6,3744,2006,1738,0.535790598,,,
Government of Rajasthan,2019,7,3982,2592,1390,0.650929181,,,
Government of Rajasthan,2019,8,3060,2097,963,0.685294118,,,
Government of Rajasthan,2019,9,4430,2065,2365,0.466139955,,,
Government of Rajasthan,2019,10,3519,2729,790,0.775504405,,,
Government of Rajasthan,2019,11,109,189,-80,1.733944954,,,
Government of Sikkim,2016,7,17,1,16,0.058823529,,,
Government of Sikkim,2017,11,13,1,12,0.076923077,,,
Government of Sikkim,2018,5,13,2,11,0.153846154,,,
Government of Sikkim,2018,7,12,1,11,0.083333333,,,
Government of Sikkim,2018,8,15,5,10,0.333333333,,,
Government of Sikkim,2018,9,9,3,6,0.333333333,,,
Government of Sikkim,2018,10,13,1,12,0.076923077,,,
Government of Sikkim,2018,12,11,1,10,0.090909091,,,
Government of Sikkim,2019,2,8,20,-12,2.5,,,
Government of Sikkim,2019,3,3,2,1,0.666666667,,,
Government of Sikkim,2019,6,18,1,17,0.055555556,,,
Government of Tamil Nadu,2016,1,718,104,614,0.144846797,,,
Government of Tamil Nadu,2016,2,811,265,546,0.32675709,,,
Government of Tamil Nadu,2016,3,731,328,403,0.44870041,,,
Government of Tamil Nadu,2016,4,685,279,406,0.40729927,,,
Government of Tamil Nadu,2016,5,700,326,374,0.465714286,,,
Government of Tamil Nadu,2016,6,939,1090,-151,1.160809372,,,
Government of Tamil Nadu,2016,7,852,425,427,0.498826291,,,
Government of Tamil Nadu,2016,8,897,444,453,0.494983278,,,
Government of Tamil Nadu,2016,9,888,768,120,0.864864865,,,
Government of Tamil Nadu,2016,10,687,396,291,0.576419214,,,
Government of Tamil Nadu,2016,11,966,1168,-202,1.209109731,,,
Government of Tamil Nadu,2016,12,1834,416,1418,0.226826609,,,
Government of Tamil Nadu,2017,1,1391,664,727,0.477354421,,,
Government of Tamil Nadu,2017,2,1146,850,296,0.741710297,,,
Government of Tamil Nadu,2017,3,1260,1131,129,0.897619048,,,
Government of Tamil Nadu,2017,4,1130,647,483,0.572566372,,,
Government of Tamil Nadu,2017,5,1314,1200,114,0.913242009,,,
Government of Tamil Nadu,2017,6,1163,798,365,0.686156492,,,
Government of Tamil Nadu,2017,7,1311,812,499,0.619374523,,,
Government of Tamil Nadu,2017,8,1304,801,503,0.614263804,,,
Government of Tamil Nadu,2017,9,1012,414,598,0.409090909,,,
Government of Tamil Nadu,2017,10,887,444,443,0.500563698,,,
Government of Tamil Nadu,2017,11,1171,748,423,0.638770282,,,
Government of Tamil Nadu,2017,12,981,496,485,0.505606524,,,
Government of Tamil Nadu,2018,1,895,607,288,0.678212291,,,
Government of Tamil Nadu,2018,2,918,595,323,0.648148148,,,
Government of Tamil Nadu,2018,3,926,577,349,0.623110151,,,
Government of Tamil Nadu,2018,4,1174,603,571,0.51362862,,,
Government of Tamil Nadu,2018,5,1442,582,860,0.403606103,,,
Government of Tamil Nadu,2018,6,1172,443,729,0.377986348,,,
Government of Tamil Nadu,2018,7,1738,677,1061,0.389528193,,,
Government of Tamil Nadu,2018,8,1282,623,659,0.485959438,,,
Government of Tamil Nadu,2018,9,1235,658,577,0.532793522,,,
Government of Tamil Nadu,2018,10,1488,624,864,0.419354839,,,
Government of Tamil Nadu,2018,11,1000,843,157,0.843,,,
Government of Tamil Nadu,2018,12,1221,678,543,0.555282555,,,
Government of Tamil Nadu,2019,1,1355,881,474,0.650184502,,,
Government of Tamil Nadu,2019,2,1271,774,497,0.608969315,,,
Government of Tamil Nadu,2019,3,1703,399,1304,0.234292425,,,
Government of Tamil Nadu,2019,4,997,305,692,0.305917753,,,
Government of Tamil Nadu,2019,5,861,461,400,0.535423926,,,
Government of Tamil Nadu,2019,6,1676,1274,402,0.760143198,,,
Government of Tamil Nadu,2019,7,1834,1058,776,0.576881134,,,
Government of Tamil Nadu,2019,8,1553,590,963,0.379909852,,,
Government of Tamil Nadu,2019,9,1737,1117,620,0.643062752,,,
Government of Tamil Nadu,2019,10,1816,1975,-159,1.087555066,,,
Government of Tamil Nadu,2019,11,59,44,15,0.745762712,,,
Government of Telangana,2016,2,312,1,311,0.003205128,,,
Government of Telangana,2016,3,355,1,354,0.002816901,,,
Government of Telangana,2016,4,372,1,371,0.002688172,,,
Government of Telangana,2016,5,360,1,359,0.002777778,,,
Government of Telangana,2016,7,347,1,346,0.002881844,,,
Government of Telangana,2016,8,431,1,430,0.002320186,,,
Government of Telangana,2016,9,388,2,386,0.005154639,,,
Government of Telangana,2016,11,430,1,429,0.002325581,,,
Government of Telangana,2016,12,637,1,636,0.001569859,,,
Government of Telangana,2017,5,494,144,350,0.291497976,,,
Government of Telangana,2017,6,564,403,161,0.714539007,,,
Government of Telangana,2017,7,509,453,56,0.889980354,,,
Government of Telangana,2017,8,564,384,180,0.680851064,,,
Government of Telangana,2017,9,429,282,147,0.657342657,,,
Government of Telangana,2017,10,451,515,-64,1.141906874,,,
Government of Telangana,2017,11,500,413,87,0.826,,,
Government of Telangana,2017,12,362,351,11,0.96961326,,,
Government of Telangana,2018,1,390,466,-76,1.194871795,,,
Government of Telangana,2018,2,378,436,-58,1.153439153,,,
Government of Telangana,2018,3,417,346,71,0.829736211,,,
Government of Telangana,2018,4,390,398,-8,1.020512821,,,
Government of Telangana,2018,5,592,489,103,0.826013514,,,
Government of Telangana,2018,6,474,499,-25,1.052742616,,,
Government of Telangana,2018,7,846,666,180,0.787234043,,,
Government of Telangana,2018,8,556,979,-423,1.760791367,,,
Government of Telangana,2018,9,459,855,-396,1.862745098,,,
Government of Telangana,2018,10,619,572,47,0.924071082,,,
Government of Telangana,2018,11,660,353,307,0.534848485,,,
Government of Telangana,2018,12,549,403,146,0.734061931,,,
Government of Telangana,2019,1,670,475,195,0.708955224,,,
Government of Telangana,2019,2,582,547,35,0.939862543,,,
Government of Telangana,2019,3,911,1447,-536,1.588364435,,,
Government of Telangana,2019,4,570,1160,-590,2.035087719,,,
Government of Telangana,2019,5,680,2861,-2181,4.207352941,,,
Government of Telangana,2019,6,824,1049,-225,1.273058252,,,
Government of Telangana,2019,7,867,1125,-258,1.297577855,,,
Government of Telangana,2019,8,595,1748,-1153,2.937815126,,,
Government of Telangana,2019,9,711,383,328,0.538677918,,,
Government of Telangana,2019,10,546,435,111,0.796703297,,,
Government of Telangana,2019,11,35,25,10,0.714285714,,,
Government of Tripura,2016,2,16,1,15,0.0625,,,
Government of Tripura,2016,3,31,11,20,0.35483871,,,
Government of Tripura,2016,4,18,1,17,0.055555556,,,
Government of Tripura,2016,6,54,4,50,0.074074074,,,
Government of Tripura,2016,7,56,6,50,0.107142857,,,
Government of Tripura,2016,8,61,8,53,0.131147541,,,
Government of Tripura,2016,10,42,4,38,0.095238095,,,
Government of Tripura,2016,11,43,4,39,0.093023256,,,
Government of Tripura,2016,12,78,3,75,0.038461538,,,
Government of Tripura,2017,1,69,1,68,0.014492754,,,
Government of Tripura,2017,2,60,1,59,0.016666667,,,
Government of Tripura,2017,3,68,11,57,0.161764706,,,
Government of Tripura,2017,4,62,3,59,0.048387097,,,
Government of Tripura,2017,5,74,1,73,0.013513514,,,
Government of Tripura,2017,6,77,24,53,0.311688312,,,
Government of Tripura,2017,7,69,8,61,0.115942029,,,
Government of Tripura,2017,8,71,2,69,0.028169014,,,
Government of Tripura,2017,9,51,16,35,0.31372549,,,
Government of Tripura,2017,10,54,18,36,0.333333333,,,
Government of Tripura,2017,11,47,1,46,0.021276596,,,
Government of Tripura,2017,12,44,3,41,0.068181818,,,
Government of Tripura,2018,1,46,6,40,0.130434783,,,
Government of Tripura,2018,2,44,10,34,0.227272727,,,
Government of Tripura,2018,3,71,67,4,0.943661972,,,
Government of Tripura,2018,4,97,127,-30,1.309278351,,,
Government of Tripura,2018,5,97,185,-88,1.907216495,,,
Government of Tripura,2018,6,82,339,-257,4.134146341,,,
Government of Tripura,2018,7,77,262,-185,3.402597403,,,
Government of Tripura,2018,8,67,104,-37,1.552238806,,,
Government of Tripura,2018,9,43,71,-28,1.651162791,,,
Government of Tripura,2018,10,60,26,34,0.433333333,,,
Government of Tripura,2018,11,48,37,11,0.770833333,,,
Government of Tripura,2018,12,65,39,26,0.6,,,
Government of Tripura,2019,1,91,84,7,0.923076923,,,
Government of Tripura,2019,2,59,110,-51,1.86440678,,,
Government of Tripura,2019,3,68,92,-24,1.352941176,,,
Government of Tripura,2019,4,60,54,6,0.9,,,
Government of Tripura,2019,5,78,94,-16,1.205128205,,,
Government of Tripura,2019,6,83,64,19,0.771084337,,,
Government of Tripura,2019,7,84,137,-53,1.630952381,,,
Government of Tripura,2019,8,73,85,-12,1.164383562,,,
Government of Tripura,2019,9,97,87,10,0.896907216,,,
Government of Tripura,2019,10,96,146,-50,1.520833333,,,
Government of Tripura,2019,11,3,9,-6,3,,,
Government of Union Territory of Chandigarh,2016,4,79,1,78,0.012658228,,,
Government of Union Territory of Chandigarh,2016,5,107,2,105,0.018691589,,,
Government of Union Territory of Chandigarh,2016,6,124,2,122,0.016129032,,,
Government of Union Territory of Chandigarh,2016,7,114,1,113,0.00877193,,,
Government of Union Territory of Chandigarh,2016,8,117,3,114,0.025641026,,,
Government of Union Territory of Chandigarh,2016,9,105,8,97,0.076190476,,,
Government of Union Territory of Chandigarh,2016,10,121,2,119,0.016528926,,,
Government of Union Territory of Chandigarh,2016,11,84,2,82,0.023809524,,,
Government of Union Territory of Chandigarh,2016,12,137,2,135,0.01459854,,,
Government of Union Territory of Chandigarh,2017,1,106,12,94,0.113207547,,,
Government of Union Territory of Chandigarh,2017,2,134,41,93,0.305970149,,,
Government of Union Territory of Chandigarh,2017,3,166,79,87,0.475903614,,,
Government of Union Territory of Chandigarh,2017,4,208,1608,-1400,7.730769231,,,
Government of Union Territory of Chandigarh,2017,5,268,276,-8,1.029850746,,,
Government of Union Territory of Chandigarh,2017,6,193,201,-8,1.041450777,,,
Government of Union Territory of Chandigarh,2017,7,280,273,7,0.975,,,
Government of Union Territory of Chandigarh,2017,8,234,226,8,0.965811966,,,
Government of Union Territory of Chandigarh,2017,9,279,258,21,0.924731183,,,
Government of Union Territory of Chandigarh,2017,10,188,192,-4,1.021276596,,,
Government of Union Territory of Chandigarh,2017,11,197,186,11,0.944162437,,,
Government of Union Territory of Chandigarh,2017,12,247,228,19,0.923076923,,,
Government of Union Territory of Chandigarh,2018,1,251,238,13,0.948207171,,,
Government of Union Territory of Chandigarh,2018,2,165,172,-7,1.042424242,,,
Government of Union Territory of Chandigarh,2018,3,211,225,-14,1.066350711,,,
Government of Union Territory of Chandigarh,2018,4,234,231,3,0.987179487,,,
Government of Union Territory of Chandigarh,2018,5,279,244,35,0.874551971,,,
Government of Union Territory of Chandigarh,2018,6,197,224,-27,1.137055838,,,
Government of Union Territory of Chandigarh,2018,7,243,227,16,0.934156379,,,
Government of Union Territory of Chandigarh,2018,8,197,188,9,0.954314721,,,
Government of Union Territory of Chandigarh,2018,9,311,313,-2,1.006430868,,,
Government of Union Territory of Chandigarh,2018,10,232,231,1,0.995689655,,,
Government of Union Territory of Chandigarh,2018,11,197,196,1,0.994923858,,,
Government of Union Territory of Chandigarh,2018,12,337,332,5,0.985163205,,,
Government of Union Territory of Chandigarh,2019,1,207,201,6,0.971014493,,,
Government of Union Territory of Chandigarh,2019,2,215,228,-13,1.060465116,,,
Government of Union Territory of Chandigarh,2019,3,263,275,-12,1.045627376,,,
Government of Union Territory of Chandigarh,2019,4,230,178,52,0.773913043,,,
Government of Union Territory of Chandigarh,2019,5,241,191,50,0.79253112,,,
Government of Union Territory of Chandigarh,2019,6,308,232,76,0.753246753,,,
Government of Union Territory of Chandigarh,2019,7,356,381,-25,1.070224719,,,
Government of Union Territory of Chandigarh,2019,8,331,257,74,0.776435045,,,
Government of Union Territory of Chandigarh,2019,9,344,298,46,0.86627907,,,
Government of Union Territory of Chandigarh,2019,10,295,392,-97,1.328813559,,,
Government of Union Territory of Dadra & Nagar Haveli,2016,1,18,1,17,0.055555556,,,
Government of Union Territory of Dadra & Nagar Haveli,2016,2,25,1,24,0.04,,,
Government of Union Territory of Dadra & Nagar Haveli,2016,12,35,1,34,0.028571429,,,
Government of Union Territory of Dadra & Nagar Haveli,2017,3,24,2,22,0.083333333,,,
Government of Union Territory of Dadra & Nagar Haveli,2017,5,15,1,14,0.066666667,,,
Government of Union Territory of Dadra & Nagar Haveli,2017,6,26,7,19,0.269230769,,,
Government of Union Territory of Dadra & Nagar Haveli,2017,7,18,1,17,0.055555556,,,
Government of Union Territory of Dadra & Nagar Haveli,2017,8,20,337,-317,16.85,,,
Government of Union Territory of Dadra & Nagar Haveli,2017,9,23,25,-2,1.086956522,,,
Government of Union Territory of Dadra & Nagar Haveli,2017,10,14,7,7,0.5,,,
Government of Union Territory of Dadra & Nagar Haveli,2017,11,13,62,-49,4.769230769,,,
Government of Union Territory of Dadra & Nagar Haveli,2017,12,14,12,2,0.857142857,,,
Government of Union Territory of Dadra & Nagar Haveli,2018,1,23,31,-8,1.347826087,,,
Government of Union Territory of Dadra & Nagar Haveli,2018,2,9,7,2,0.777777778,,,
Government of Union Territory of Dadra & Nagar Haveli,2018,3,15,9,6,0.6,,,
Government of Union Territory of Dadra & Nagar Haveli,2018,4,17,9,8,0.529411765,,,
Government of Union Territory of Dadra & Nagar Haveli,2018,5,31,27,4,0.870967742,,,
Government of Union Territory of Dadra & Nagar Haveli,2018,6,13,19,-6,1.461538462,,,
Government of Union Territory of Dadra & Nagar Haveli,2018,7,20,23,-3,1.15,,,
Government of Union Territory of Dadra & Nagar Haveli,2018,8,12,4,8,0.333333333,,,
Government of Union Territory of Dadra & Nagar Haveli,2018,9,12,8,4,0.666666667,,,
Government of Union Territory of Dadra & Nagar Haveli,2018,10,19,23,-4,1.210526316,,,
Government of Union Territory of Dadra & Nagar Haveli,2018,11,7,14,-7,2,,,
Government of Union Territory of Dadra & Nagar Haveli,2018,12,9,4,5,0.444444444,,,
Government of Union Territory of Dadra & Nagar Haveli,2019,1,19,22,-3,1.157894737,,,
Government of Union Territory of Dadra & Nagar Haveli,2019,2,12,14,-2,1.166666667,,,
Government of Union Territory of Dadra & Nagar Haveli,2019,3,10,5,5,0.5,,,
Government of Union Territory of Dadra & Nagar Haveli,2019,4,8,6,2,0.75,,,
Government of Union Territory of Dadra & Nagar Haveli,2019,5,11,17,-6,1.545454545,,,
Government of Union Territory of Dadra & Nagar Haveli,2019,6,19,7,12,0.368421053,,,
Government of Union Territory of Dadra & Nagar Haveli,2019,7,17,39,-22,2.294117647,,,
Government of Union Territory of Dadra & Nagar Haveli,2019,8,22,13,9,0.590909091,,,
Government of Union Territory of Dadra & Nagar Haveli,2019,9,23,19,4,0.826086957,,,
Government of Union Territory of Dadra & Nagar Haveli,2019,10,191,12,179,0.062827225,,,
Government of Union Territory of Daman & Diu,2016,5,9,1,8,0.111111111,,,
Government of Union Territory of Daman & Diu,2016,12,26,1,25,0.038461538,,,
Government of Union Territory of Daman & Diu,2017,3,16,1,15,0.0625,,,
Government of Union Territory of Daman & Diu,2017,6,12,1,11,0.083333333,,,
Government of Union Territory of Daman & Diu,2017,7,10,33,-23,3.3,,,
Government of Union Territory of Daman & Diu,2017,8,16,85,-69,5.3125,,,
Government of Union Territory of Daman & Diu,2017,9,16,111,-95,6.9375,,,
Government of Union Territory of Daman & Diu,2017,10,23,14,9,0.608695652,,,
Government of Union Territory of Daman & Diu,2017,11,14,80,-66,5.714285714,,,
Government of Union Territory of Daman & Diu,2017,12,17,13,4,0.764705882,,,
Government of Union Territory of Daman & Diu,2018,1,13,18,-5,1.384615385,,,
Government of Union Territory of Daman & Diu,2018,2,15,17,-2,1.133333333,,,
Government of Union Territory of Daman & Diu,2018,3,24,5,19,0.208333333,,,
Government of Union Territory of Daman & Diu,2018,4,12,25,-13,2.083333333,,,
Government of Union Territory of Daman & Diu,2018,5,31,11,20,0.35483871,,,
Government of Union Territory of Daman & Diu,2018,6,18,19,-1,1.055555556,,,
Government of Union Territory of Daman & Diu,2018,7,20,29,-9,1.45,,,
Government of Union Territory of Daman & Diu,2018,8,14,15,-1,1.071428571,,,
Government of Union Territory of Daman & Diu,2018,9,16,12,4,0.75,,,
Government of Union Territory of Daman & Diu,2018,10,19,18,1,0.947368421,,,
Government of Union Territory of Daman & Diu,2018,11,16,16,0,1,,,
Government of Union Territory of Daman & Diu,2018,12,27,14,13,0.518518519,,,
Government of Union Territory of Daman & Diu,2019,1,34,58,-24,1.705882353,,,
Government of Union Territory of Daman & Diu,2019,2,20,6,14,0.3,,,
Government of Union Territory of Daman & Diu,2019,3,18,17,1,0.944444444,,,
Government of Union Territory of Daman & Diu,2019,4,11,18,-7,1.636363636,,,
Government of Union Territory of Daman & Diu,2019,5,8,18,-10,2.25,,,
Government of Union Territory of Daman & Diu,2019,6,14,12,2,0.857142857,,,
Government of Union Territory of Daman & Diu,2019,7,10,14,-4,1.4,,,
Government of Union Territory of Daman & Diu,2019,8,23,17,6,0.739130435,,,
Government of Union Territory of Daman & Diu,2019,9,27,23,4,0.851851852,,,
Government of Union Territory of Daman & Diu,2019,10,40,44,-4,1.1,,,
Government of Union Territory of Daman & Diu,2019,11,1,1,0,1,,,
Government of Union Territory of Lakshadweep,2016,5,3,1,2,0.333333333,,,
Government of Union Territory of Lakshadweep,2016,6,6,3,3,0.5,,,
Government of Union Territory of Lakshadweep,2016,7,11,4,7,0.363636364,,,
Government of Union Territory of Lakshadweep,2016,8,8,11,-3,1.375,,,
Government of Union Territory of Lakshadweep,2016,10,17,16,1,0.941176471,,,
Government of Union Territory of Lakshadweep,2016,11,12,17,-5,1.416666667,,,
Government of Union Territory of Lakshadweep,2016,12,11,10,1,0.909090909,,,
Government of Union Territory of Lakshadweep,2017,1,10,7,3,0.7,,,
Government of Union Territory of Lakshadweep,2017,3,14,7,7,0.5,,,
Government of Union Territory of Lakshadweep,2017,4,10,8,2,0.8,,,
Government of Union Territory of Lakshadweep,2017,5,9,6,3,0.666666667,,,
Government of Union Territory of Lakshadweep,2017,6,4,8,-4,2,,,
Government of Union Territory of Lakshadweep,2017,7,4,7,-3,1.75,,,
Government of Union Territory of Lakshadweep,2017,8,4,10,-6,2.5,,,
Government of Union Territory of Lakshadweep,2017,9,7,17,-10,2.428571429,,,
Government of Union Territory of Lakshadweep,2017,10,2,12,-10,6,,,
Government of Union Territory of Lakshadweep,2017,11,8,3,5,0.375,,,
Government of Union Territory of Lakshadweep,2017,12,9,4,5,0.444444444,,,
Government of Union Territory of Lakshadweep,2018,1,7,4,3,0.571428571,,,
Government of Union Territory of Lakshadweep,2018,2,11,18,-7,1.636363636,,,
Government of Union Territory of Lakshadweep,2018,3,7,15,-8,2.142857143,,,
Government of Union Territory of Lakshadweep,2018,4,8,7,1,0.875,,,
Government of Union Territory of Lakshadweep,2018,5,5,13,-8,2.6,,,
Government of Union Territory of Lakshadweep,2018,6,6,3,3,0.5,,,
Government of Union Territory of Lakshadweep,2018,7,3,2,1,0.666666667,,,
Government of Union Territory of Lakshadweep,2018,8,5,4,1,0.8,,,
Government of Union Territory of Lakshadweep,2018,9,4,6,-2,1.5,,,
Government of Union Territory of Lakshadweep,2018,10,7,7,0,1,,,
Government of Union Territory of Lakshadweep,2018,11,6,2,4,0.333333333,,,
Government of Union Territory of Lakshadweep,2018,12,4,1,3,0.25,,,
Government of Union Territory of Lakshadweep,2019,1,5,9,-4,1.8,,,
Government of Union Territory of Lakshadweep,2019,2,5,1,4,0.2,,,
Government of Union Territory of Lakshadweep,2019,4,4,5,-1,1.25,,,
Government of Union Territory of Lakshadweep,2019,6,6,19,-13,3.166666667,,,
Government of Union Territory of Lakshadweep,2019,7,8,12,-4,1.5,,,
Government of Union Territory of Lakshadweep,2019,8,6,10,-4,1.666666667,,,
Government of Union Territory of Lakshadweep,2019,9,15,4,11,0.266666667,,,
Government of Union Territory of Lakshadweep,2019,10,1,6,-5,6,,,
Government of Uttar Pradesh,2016,1,3559,6,3553,0.001685867,,503114,
Government of Uttar Pradesh,2016,2,4255,4,4251,0.000940071,,62414,
Government of Uttar Pradesh,2016,3,5008,8,5000,0.001597444,,0.124055383,
Government of Uttar Pradesh,2016,4,4969,16,4953,0.003219964,,,
Government of Uttar Pradesh,2016,5,5877,90,5787,0.015313936,,,
Government of Uttar Pradesh,2016,6,7178,532,6646,0.074115352,,0.06909766,
Government of Uttar Pradesh,2016,7,5886,3568,2318,0.606184166,,,
Government of Uttar Pradesh,2016,8,7120,6492,628,0.911797753,,,
Government of Uttar Pradesh,2016,9,7483,4011,3472,0.536014967,,,
Government of Uttar Pradesh,2016,10,6498,7647,-1149,1.176823638,,,
Government of Uttar Pradesh,2016,11,5358,8429,-3071,1.573161627,,,
Government of Uttar Pradesh,2016,12,8993,6617,2376,0.735794507,,,
Government of Uttar Pradesh,2017,1,7985,4034,3951,0.505197245,,,
Government of Uttar Pradesh,2017,2,7200,4166,3034,0.578611111,,,
Government of Uttar Pradesh,2017,3,9842,9285,557,0.943405812,,,
Government of Uttar Pradesh,2017,4,13892,7071,6821,0.508997984,,,
Government of Uttar Pradesh,2017,5,12488,11442,1046,0.91623959,,,
Government of Uttar Pradesh,2017,6,10815,13250,-2435,1.225150254,,,
Government of Uttar Pradesh,2017,7,9678,19167,-9489,1.980471172,,,
Government of Uttar Pradesh,2017,8,11257,12166,-909,1.080749756,,,
Government of Uttar Pradesh,2017,9,10810,11474,-664,1.061424607,,,
Government of Uttar Pradesh,2017,10,9308,11487,-2179,1.234099699,,,
Government of Uttar Pradesh,2017,11,9443,12234,-2791,1.295562851,,,
Government of Uttar Pradesh,2017,12,9394,12745,-3351,1.356717053,,,
Government of Uttar Pradesh,2018,1,9960,12408,-2448,1.245783133,,,
Government of Uttar Pradesh,2018,2,9199,8704,495,0.946189803,,,
Government of Uttar Pradesh,2018,3,9944,7728,2216,0.777152051,,,
Government of Uttar Pradesh,2018,4,10386,6425,3961,0.618621221,,,
Government of Uttar Pradesh,2018,5,12142,6620,5522,0.545214956,,,
Government of Uttar Pradesh,2018,6,11045,7401,3644,0.670076958,,,
Government of Uttar Pradesh,2018,7,13228,12030,1198,0.909434533,,,
Government of Uttar Pradesh,2018,8,11473,16225,-4752,1.414189837,,,
Government of Uttar Pradesh,2018,9,12664,16022,-3358,1.265161087,,,
Government of Uttar Pradesh,2018,10,13519,10874,2645,0.804349434,,,
Government of Uttar Pradesh,2018,11,9920,4883,5037,0.492237903,,,
Government of Uttar Pradesh,2018,12,11570,11780,-210,1.018150389,,,
Government of Uttar Pradesh,2019,1,14141,11752,2389,0.831058624,,,
Government of Uttar Pradesh,2019,2,14406,15444,-1038,1.072053311,,,
Government of Uttar Pradesh,2019,3,12839,11849,990,0.922891191,,,
Government of Uttar Pradesh,2019,4,10969,14301,-3332,1.303765156,,,
Government of Uttar Pradesh,2019,5,11047,19392,-8345,1.755408708,,,
Government of Uttar Pradesh,2019,6,20351,17481,2870,0.858974989,,,
Government of Uttar Pradesh,2019,7,24977,25005,-28,1.001121031,,,
Government of Uttar Pradesh,2019,8,19625,19579,46,0.997656051,,,
Government of Uttar Pradesh,2019,9,24081,18555,5526,0.77052448,,,
Government of Uttar Pradesh,2019,10,20608,296,20312,0.014363354,,,
Government of Uttar Pradesh,2019,11,724,5,719,0.006906077,,,
Government of Uttarakhand,2016,1,327,3,324,0.009174312,,,
Government of Uttarakhand,2016,2,351,3,348,0.008547009,,,
Government of Uttarakhand,2016,3,381,2,379,0.005249344,,,
Government of Uttarakhand,2016,5,502,1,501,0.001992032,,,
Government of Uttarakhand,2016,6,534,1,533,0.001872659,,,
Government of Uttarakhand,2016,8,620,2,618,0.003225806,,,
Government of Uttarakhand,2016,9,560,6,554,0.010714286,,,
Government of Uttarakhand,2016,10,524,3,521,0.005725191,,,
Government of Uttarakhand,2016,11,438,2,436,0.00456621,,,
Government of Uttarakhand,2016,12,677,6,671,0.008862629,,,
Government of Uttarakhand,2017,1,709,16,693,0.022566996,,,
Government of Uttarakhand,2017,2,597,4,593,0.006700168,,,
Government of Uttarakhand,2017,3,792,32,760,0.04040404,,,
Government of Uttarakhand,2017,4,1274,29,1245,0.022762951,,,
Government of Uttarakhand,2017,5,1238,37,1201,0.029886914,,,
Government of Uttarakhand,2017,6,819,20,799,0.024420024,,,
Government of Uttarakhand,2017,7,820,100,720,0.12195122,,,
Government of Uttarakhand,2017,8,944,107,837,0.113347458,,,
Government of Uttarakhand,2017,9,920,198,722,0.215217391,,,
Government of Uttarakhand,2017,10,780,208,572,0.266666667,,,
Government of Uttarakhand,2017,11,769,125,644,0.162548765,,,
Government of Uttarakhand,2017,12,683,59,624,0.086383602,,,
Government of Uttarakhand,2018,1,884,68,816,0.076923077,,,
Government of Uttarakhand,2018,2,954,61,893,0.0639413,,,
Government of Uttarakhand,2018,3,856,42,814,0.049065421,,,
Government of Uttarakhand,2018,4,788,68,720,0.086294416,,,
Government of Uttarakhand,2018,5,1057,90,967,0.085146641,,,
Government of Uttarakhand,2018,6,1086,72,1014,0.066298343,,,
Government of Uttarakhand,2018,7,1080,120,960,0.111111111,,,
Government of Uttarakhand,2018,8,959,123,836,0.128258603,,,
Government of Uttarakhand,2018,9,949,67,882,0.070600632,,,
Government of Uttarakhand,2018,10,1054,47,1007,0.04459203,,,
Government of Uttarakhand,2018,11,653,59,594,0.090352221,,,
Government of Uttarakhand,2018,12,743,62,681,0.083445491,,,
Government of Uttarakhand,2019,1,883,81,802,0.091732729,,,
Government of Uttarakhand,2019,2,1054,967,87,0.917457306,,,
Government of Uttarakhand,2019,3,937,70,867,0.07470651,,,
Government of Uttarakhand,2019,4,587,39,548,0.066439523,,,
Government of Uttarakhand,2019,5,629,39,590,0.06200318,,,
Government of Uttarakhand,2019,6,1411,33,1378,0.023387668,,,
Government of Uttarakhand,2019,7,1418,67,1351,0.047249647,,,
Government of Uttarakhand,2019,8,1227,41,1186,0.033414833,,,
Government of Uttarakhand,2019,9,1461,61,1400,0.041752225,,,
Government of Uttarakhand,2019,10,1106,51,1055,0.046112116,,,
Government of West Bengal,2016,1,430,1,429,0.002325581,,,
Government of West Bengal,2016,2,453,1,452,0.002207506,,,
Government of West Bengal,2016,3,503,2,501,0.003976143,,,
Government of West Bengal,2016,4,437,4,433,0.009153318,,,
Government of West Bengal,2016,5,458,1,457,0.002183406,,,
Government of West Bengal,2016,6,649,2,647,0.003081664,,,
Government of West Bengal,2016,7,640,4,636,0.00625,,,
Government of West Bengal,2016,8,822,3,819,0.003649635,,,
Government of West Bengal,2016,9,802,5,797,0.006234414,,,
Government of West Bengal,2016,10,592,3,589,0.005067568,,,
Government of West Bengal,2016,11,708,1,707,0.001412429,,,
Government of West Bengal,2016,12,1027,3,1024,0.00292113,,,
Government of West Bengal,2017,1,716,2,714,0.002793296,,,
Government of West Bengal,2017,2,816,2,814,0.00245098,,,
Government of West Bengal,2017,3,917,1,916,0.001090513,,,
Government of West Bengal,2017,4,918,2,916,0.002178649,,,
Government of West Bengal,2017,5,1140,1,1139,0.000877193,,,
Government of West Bengal,2017,6,978,5,973,0.005112474,,,
Government of West Bengal,2017,7,1038,8,1030,0.007707129,,,
Government of West Bengal,2017,8,1101,3,1098,0.002724796,,,
Government of West Bengal,2017,9,720,3,717,0.004166667,,,
Government of West Bengal,2017,10,647,2,645,0.00309119,,,
Government of West Bengal,2017,11,785,4,781,0.005095541,,,
Government of West Bengal,2017,12,555,3,552,0.005405405,,,
Government of West Bengal,2018,1,581,3,578,0.005163511,,,
Government of West Bengal,2018,2,609,1,608,0.001642036,,,
Government of West Bengal,2018,3,558,2,556,0.003584229,,,
Government of West Bengal,2018,4,666,5,661,0.007507508,,,
Government of West Bengal,2018,5,991,48,943,0.048435923,,,
Government of West Bengal,2018,6,1058,49,1009,0.0463138,,,
Government of West Bengal,2018,7,950,77,873,0.081052632,,,
Government of West Bengal,2018,8,806,81,725,0.100496278,,,
Government of West Bengal,2018,9,809,61,748,0.075401731,,,
Government of West Bengal,2018,10,730,36,694,0.049315068,,,
Government of West Bengal,2018,11,614,43,571,0.070032573,,,
Government of West Bengal,2018,12,845,38,807,0.044970414,,,
Government of West Bengal,2019,1,924,46,878,0.04978355,,,
Government of West Bengal,2019,2,1045,1626,-581,1.555980861,,,
Government of West Bengal,2019,3,1367,38,1329,0.027798098,,,
Government of West Bengal,2019,4,952,47,905,0.049369748,,,
Government of West Bengal,2019,5,823,49,774,0.059538275,,,
Government of West Bengal,2019,6,1569,61,1508,0.038878266,,,
Government of West Bengal,2019,7,2073,59,2014,0.028461167,,,
Government of West Bengal,2019,8,1418,36,1382,0.02538787,,,
Government of West Bengal,2019,9,1858,70,1788,0.037674919,,,
Government of West Bengal,2019,10,1416,62,1354,0.043785311,,,
Investment Grievance Redress Cell,2016,10,15,1,14,0.066666667,,,
Legislative Department,2016,1,39,11,28,0.282051282,,,
Legislative Department,2016,2,42,28,14,0.666666667,,,
Legislative Department,2016,3,56,50,6,0.892857143,,,
Legislative Department,2016,4,39,41,-2,1.051282051,,,
Legislative Department,2016,5,34,21,13,0.617647059,,,
Legislative Department,2016,6,30,27,3,0.9,,,
Legislative Department,2016,7,49,29,20,0.591836735,,,
Legislative Department,2016,8,48,34,14,0.708333333,,,
Legislative Department,2016,9,51,38,13,0.745098039,,,
Legislative Department,2016,10,43,47,-4,1.093023256,,,
Legislative Department,2016,11,49,48,1,0.979591837,,,
Legislative Department,2016,12,34,30,4,0.882352941,,,
Legislative Department,2017,1,74,48,26,0.648648649,,,
Legislative Department,2017,2,48,51,-3,1.0625,,,
Legislative Department,2017,3,63,37,26,0.587301587,,,
Legislative Department,2017,4,57,56,1,0.98245614,,,
Legislative Department,2017,5,57,106,-49,1.859649123,,,
Legislative Department,2017,6,60,81,-21,1.35,,,
Legislative Department,2017,7,62,41,21,0.661290323,,,
Legislative Department,2017,8,65,60,5,0.923076923,,,
Legislative Department,2017,9,50,29,21,0.58,,,
Legislative Department,2017,10,41,42,-1,1.024390244,,,
Legislative Department,2017,11,43,56,-13,1.302325581,,,
Legislative Department,2017,12,48,17,31,0.354166667,,,
Legislative Department,2018,1,50,35,15,0.7,,,
Legislative Department,2018,2,60,52,8,0.866666667,,,
Legislative Department,2018,3,63,53,10,0.841269841,,,
Legislative Department,2018,4,58,32,26,0.551724138,,,
Legislative Department,2018,5,101,92,9,0.910891089,,,
Legislative Department,2018,6,28,26,2,0.928571429,,,
Legislative Department,2018,7,33,16,17,0.484848485,,,
Legislative Department,2018,8,51,58,-7,1.137254902,,,
Legislative Department,2018,9,51,167,-116,3.274509804,,,
Legislative Department,2018,10,55,45,10,0.818181818,,,
Legislative Department,2018,11,60,42,18,0.7,,,
Legislative Department,2018,12,64,64,0,1,,,
Legislative Department,2019,1,65,33,32,0.507692308,,,
Legislative Department,2019,2,78,95,-17,1.217948718,,,
Legislative Department,2019,3,90,69,21,0.766666667,,,
Legislative Department,2019,4,82,39,43,0.475609756,,,
Legislative Department,2019,5,66,27,39,0.409090909,,,
Legislative Department,2019,6,61,23,38,0.37704918,,,
Legislative Department,2019,7,65,41,24,0.630769231,,,
Legislative Department,2019,8,77,86,-9,1.116883117,,,
Legislative Department,2019,9,93,37,56,0.397849462,,,
Legislative Department,2019,10,67,12,55,0.179104478,,,
Legislative Department,2019,11,1,6,-5,6,,,
Ministry  of Coal,2016,1,221,62,159,0.280542986,,,
Ministry  of Coal,2016,2,238,114,124,0.478991597,,,
Ministry  of Coal,2016,3,229,50,179,0.218340611,,,
Ministry  of Coal,2016,4,237,111,126,0.46835443,,,
Ministry  of Coal,2016,5,246,198,48,0.804878049,,,
Ministry  of Coal,2016,6,342,263,79,0.769005848,,,
Ministry  of Coal,2016,7,269,327,-58,1.215613383,,,
Ministry  of Coal,2016,8,287,274,13,0.954703833,,,
Ministry  of Coal,2016,9,278,127,151,0.456834532,,,
Ministry  of Coal,2016,10,240,214,26,0.891666667,,,
Ministry  of Coal,2016,11,201,255,-54,1.268656716,,,
Ministry  of Coal,2016,12,274,332,-58,1.211678832,,,
Ministry  of Coal,2017,1,314,148,166,0.47133758,,,
Ministry  of Coal,2017,2,326,198,128,0.607361963,,,
Ministry  of Coal,2017,3,859,482,377,0.561117579,,,
Ministry  of Coal,2017,4,553,934,-381,1.688969259,,,
Ministry  of Coal,2017,5,708,398,310,0.562146893,,,
Ministry  of Coal,2017,6,507,223,284,0.439842209,,,
Ministry  of Coal,2017,7,638,277,361,0.434169279,,,
Ministry  of Coal,2017,8,718,694,24,0.966573816,,,
Ministry  of Coal,2017,9,776,598,178,0.770618557,,,
Ministry  of Coal,2017,10,596,837,-241,1.404362416,,,
Ministry  of Coal,2017,11,580,666,-86,1.148275862,,,
Ministry  of Coal,2017,12,483,665,-182,1.376811594,,,
Ministry  of Coal,2018,1,355,619,-264,1.743661972,,,
Ministry  of Coal,2018,2,387,500,-113,1.291989664,,,
Ministry  of Coal,2018,3,384,577,-193,1.502604167,,,
Ministry  of Coal,2018,4,409,600,-191,1.466992665,,,
Ministry  of Coal,2018,5,438,611,-173,1.394977169,,,
Ministry  of Coal,2018,6,398,387,11,0.972361809,,,
Ministry  of Coal,2018,7,467,502,-35,1.074946467,,,
Ministry  of Coal,2018,8,389,422,-33,1.084832905,,,
Ministry  of Coal,2018,9,370,434,-64,1.172972973,,,
Ministry  of Coal,2018,10,375,360,15,0.96,,,
Ministry  of Coal,2018,11,349,316,33,0.905444126,,,
Ministry  of Coal,2018,12,395,336,59,0.850632911,,,
Ministry  of Coal,2019,1,384,415,-31,1.080729167,,,
Ministry  of Coal,2019,2,347,310,37,0.893371758,,,
Ministry  of Coal,2019,3,348,470,-122,1.350574713,,,
Ministry  of Coal,2019,4,318,250,68,0.786163522,,,
Ministry  of Coal,2019,5,245,195,50,0.795918367,,,
Ministry  of Coal,2019,6,296,277,19,0.935810811,,,
Ministry  of Coal,2019,7,440,318,122,0.722727273,,,
Ministry  of Coal,2019,8,367,431,-64,1.174386921,,,
Ministry  of Coal,2019,9,426,384,42,0.901408451,,,
Ministry  of Coal,2019,10,321,416,-95,1.295950156,,,
Ministry  of Coal,2019,11,15,24,-9,1.6,,,
Ministry of Ayush,2016,1,87,19,68,0.218390805,,,
Ministry of Ayush,2016,2,130,65,65,0.5,,,
Ministry of Ayush,2016,3,139,128,11,0.920863309,,,
Ministry of Ayush,2016,4,122,118,4,0.967213115,,,
Ministry of Ayush,2016,5,128,176,-48,1.375,,,
Ministry of Ayush,2016,6,269,122,147,0.453531599,,,
Ministry of Ayush,2016,7,187,225,-38,1.203208556,,,
Ministry of Ayush,2016,8,170,152,18,0.894117647,,,
Ministry of Ayush,2016,9,160,146,14,0.9125,,,
Ministry of Ayush,2016,10,130,99,31,0.761538462,,,
Ministry of Ayush,2016,11,125,115,10,0.92,,,
Ministry of Ayush,2016,12,205,101,104,0.492682927,,,
Ministry of Ayush,2017,1,696,218,478,0.313218391,,,
Ministry of Ayush,2017,2,108,61,47,0.564814815,,,
Ministry of Ayush,2017,3,187,294,-107,1.572192513,,,
Ministry of Ayush,2017,4,195,772,-577,3.958974359,,,
Ministry of Ayush,2017,5,219,122,97,0.557077626,,,
Ministry of Ayush,2017,6,237,194,43,0.818565401,,,
Ministry of Ayush,2017,7,268,263,5,0.981343284,,,
Ministry of Ayush,2017,8,266,308,-42,1.157894737,,,
Ministry of Ayush,2017,9,139,241,-102,1.73381295,,,
Ministry of Ayush,2017,10,200,115,85,0.575,,,
Ministry of Ayush,2017,11,255,296,-41,1.160784314,,,
Ministry of Ayush,2017,12,327,280,47,0.856269113,,,
Ministry of Ayush,2018,1,205,133,72,0.648780488,,,
Ministry of Ayush,2018,2,161,198,-37,1.229813665,,,
Ministry of Ayush,2018,3,126,106,20,0.841269841,,,
Ministry of Ayush,2018,4,138,390,-252,2.826086957,,,
Ministry of Ayush,2018,5,226,198,28,0.876106195,,,
Ministry of Ayush,2018,6,125,94,31,0.752,,,
Ministry of Ayush,2018,7,200,172,28,0.86,,,
Ministry of Ayush,2018,8,177,194,-17,1.096045198,,,
Ministry of Ayush,2018,9,196,85,111,0.433673469,,,
Ministry of Ayush,2018,10,212,255,-43,1.202830189,,,
Ministry of Ayush,2018,11,118,114,4,0.966101695,,,
Ministry of Ayush,2018,12,136,164,-28,1.205882353,,,
Ministry of Ayush,2019,1,193,196,-3,1.015544041,,,
Ministry of Ayush,2019,2,262,148,114,0.564885496,,,
Ministry of Ayush,2019,3,167,170,-3,1.017964072,,,
Ministry of Ayush,2019,4,133,264,-131,1.984962406,,,
Ministry of Ayush,2019,5,98,242,-144,2.469387755,,,
Ministry of Ayush,2019,6,221,143,78,0.647058824,,,
Ministry of Ayush,2019,7,229,219,10,0.956331878,,,
Ministry of Ayush,2019,8,162,164,-2,1.012345679,,,
Ministry of Ayush,2019,9,258,228,30,0.88372093,,,
Ministry of Ayush,2019,10,377,383,-6,1.015915119,,,
Ministry of Ayush,2019,11,14,1,13,0.071428571,,,
Ministry of Civil Aviation,2016,1,373,88,285,0.235924933,,,
Ministry of Civil Aviation,2016,2,447,259,188,0.579418345,,,
Ministry of Civil Aviation,2016,3,439,235,204,0.535307517,,,
Ministry of Civil Aviation,2016,4,417,330,87,0.791366906,,,
Ministry of Civil Aviation,2016,5,461,231,230,0.501084599,,,
Ministry of Civil Aviation,2016,6,541,719,-178,1.329020333,,,
Ministry of Civil Aviation,2016,7,534,723,-189,1.353932584,,,
Ministry of Civil Aviation,2016,8,578,609,-31,1.053633218,,,
Ministry of Civil Aviation,2016,9,492,403,89,0.819105691,,,
Ministry of Civil Aviation,2016,10,460,479,-19,1.041304348,,,
Ministry of Civil Aviation,2016,11,440,494,-54,1.122727273,,,
Ministry of Civil Aviation,2016,12,630,401,229,0.636507937,,,
Ministry of Civil Aviation,2017,1,509,638,-129,1.253438114,,,
Ministry of Civil Aviation,2017,2,494,698,-204,1.412955466,,,
Ministry of Civil Aviation,2017,3,610,711,-101,1.16557377,,,
Ministry of Civil Aviation,2017,4,582,474,108,0.81443299,,,
Ministry of Civil Aviation,2017,5,621,680,-59,1.095008052,,,
Ministry of Civil Aviation,2017,6,533,496,37,0.930581614,,,
Ministry of Civil Aviation,2017,7,503,765,-262,1.520874751,,,
Ministry of Civil Aviation,2017,8,510,479,31,0.939215686,,,
Ministry of Civil Aviation,2017,9,387,433,-46,1.118863049,,,
Ministry of Civil Aviation,2017,10,404,289,115,0.715346535,,,
Ministry of Civil Aviation,2017,11,495,549,-54,1.109090909,,,
Ministry of Civil Aviation,2017,12,463,392,71,0.846652268,,,
Ministry of Civil Aviation,2018,1,388,411,-23,1.059278351,,,
Ministry of Civil Aviation,2018,2,391,289,102,0.739130435,,,
Ministry of Civil Aviation,2018,3,478,454,24,0.949790795,,,
Ministry of Civil Aviation,2018,4,394,430,-36,1.091370558,,,
Ministry of Civil Aviation,2018,5,566,449,117,0.793286219,,,
Ministry of Civil Aviation,2018,6,404,507,-103,1.254950495,,,
Ministry of Civil Aviation,2018,7,633,435,198,0.687203791,,,
Ministry of Civil Aviation,2018,8,569,507,62,0.891036907,,,
Ministry of Civil Aviation,2018,9,493,705,-212,1.430020284,,,
Ministry of Civil Aviation,2018,10,469,322,147,0.686567164,,,
Ministry of Civil Aviation,2018,11,393,595,-202,1.513994911,,,
Ministry of Civil Aviation,2018,12,429,391,38,0.911421911,,,
Ministry of Civil Aviation,2019,1,468,495,-27,1.057692308,,,
Ministry of Civil Aviation,2019,2,554,482,72,0.870036101,,,
Ministry of Civil Aviation,2019,3,575,346,229,0.60173913,,,
Ministry of Civil Aviation,2019,4,629,540,89,0.858505564,,,
Ministry of Civil Aviation,2019,5,422,801,-379,1.898104265,,,
Ministry of Civil Aviation,2019,6,691,210,481,0.303907381,,,
Ministry of Civil Aviation,2019,7,636,695,-59,1.092767296,,,
Ministry of Civil Aviation,2019,8,442,414,28,0.936651584,,,
Ministry of Civil Aviation,2019,9,484,915,-431,1.890495868,,,
Ministry of Civil Aviation,2019,10,410,388,22,0.946341463,,,
Ministry of Civil Aviation,2019,11,14,18,-4,1.285714286,,,
Ministry of Corporate Affairs,2016,1,419,111,308,0.264916468,,,
Ministry of Corporate Affairs,2016,2,568,389,179,0.684859155,,,
Ministry of Corporate Affairs,2016,3,556,476,80,0.856115108,,,
Ministry of Corporate Affairs,2016,4,705,531,174,0.753191489,,,
Ministry of Corporate Affairs,2016,5,746,993,-247,1.331099196,,,
Ministry of Corporate Affairs,2016,6,712,572,140,0.803370787,,,
Ministry of Corporate Affairs,2016,7,721,882,-161,1.223300971,,,
Ministry of Corporate Affairs,2016,8,826,664,162,0.803874092,,,
Ministry of Corporate Affairs,2016,9,950,807,143,0.849473684,,,
Ministry of Corporate Affairs,2016,10,1589,1451,138,0.913152926,,,
Ministry of Corporate Affairs,2016,11,676,650,26,0.961538462,,,
Ministry of Corporate Affairs,2016,12,754,531,223,0.704244032,,,
Ministry of Corporate Affairs,2017,1,618,783,-165,1.266990291,,,
Ministry of Corporate Affairs,2017,2,565,610,-45,1.079646018,,,
Ministry of Corporate Affairs,2017,3,658,757,-99,1.150455927,,,
Ministry of Corporate Affairs,2017,4,649,716,-67,1.103235747,,,
Ministry of Corporate Affairs,2017,5,646,714,-68,1.105263158,,,
Ministry of Corporate Affairs,2017,6,607,614,-7,1.011532125,,,
Ministry of Corporate Affairs,2017,7,577,744,-167,1.289428076,,,
Ministry of Corporate Affairs,2017,8,807,824,-17,1.021065675,,,
Ministry of Corporate Affairs,2017,9,658,573,85,0.870820669,,,
Ministry of Corporate Affairs,2017,10,578,551,27,0.953287197,,,
Ministry of Corporate Affairs,2017,11,533,500,33,0.938086304,,,
Ministry of Corporate Affairs,2017,12,471,478,-7,1.014861996,,,
Ministry of Corporate Affairs,2018,1,499,494,5,0.98997996,,,
Ministry of Corporate Affairs,2018,2,599,337,262,0.562604341,,,
Ministry of Corporate Affairs,2018,3,504,375,129,0.744047619,,,
Ministry of Corporate Affairs,2018,4,588,503,85,0.855442177,,,
Ministry of Corporate Affairs,2018,5,863,737,126,0.853997683,,,
Ministry of Corporate Affairs,2018,6,533,715,-182,1.341463415,,,
Ministry of Corporate Affairs,2018,7,784,620,164,0.790816327,,,
Ministry of Corporate Affairs,2018,8,684,588,96,0.859649123,,,
Ministry of Corporate Affairs,2018,9,924,921,3,0.996753247,,,
Ministry of Corporate Affairs,2018,10,704,1234,-530,1.752840909,,,
Ministry of Corporate Affairs,2018,11,493,521,-28,1.056795132,,,
Ministry of Corporate Affairs,2018,12,499,529,-30,1.06012024,,,
Ministry of Corporate Affairs,2019,1,553,551,2,0.996383363,,,
Ministry of Corporate Affairs,2019,2,594,418,176,0.703703704,,,
Ministry of Corporate Affairs,2019,3,629,473,156,0.751987281,,,
Ministry of Corporate Affairs,2019,4,655,733,-78,1.119083969,,,
Ministry of Corporate Affairs,2019,5,776,1048,-272,1.350515464,,,
Ministry of Corporate Affairs,2019,6,799,805,-6,1.007509387,,,
Ministry of Corporate Affairs,2019,7,884,710,174,0.803167421,,,
Ministry of Corporate Affairs,2019,8,834,1012,-178,1.213429257,,,
Ministry of Corporate Affairs,2019,9,867,1025,-158,1.182237601,,,
Ministry of Corporate Affairs,2019,10,726,532,194,0.732782369,,,
Ministry of Corporate Affairs,2019,11,19,102,-83,5.368421053,,,
Ministry of Culture,2016,1,133,47,86,0.353383459,,,
Ministry of Culture,2016,2,183,159,24,0.868852459,,,
Ministry of Culture,2016,3,172,197,-25,1.145348837,,,
Ministry of Culture,2016,4,156,145,11,0.929487179,,,
Ministry of Culture,2016,5,153,187,-34,1.222222222,,,
Ministry of Culture,2016,6,177,168,9,0.949152542,,,
Ministry of Culture,2016,7,167,183,-16,1.095808383,,,
Ministry of Culture,2016,8,188,164,24,0.872340426,,,
Ministry of Culture,2016,9,191,194,-3,1.015706806,,,
Ministry of Culture,2016,10,148,133,15,0.898648649,,,
Ministry of Culture,2016,11,168,158,10,0.94047619,,,
Ministry of Culture,2016,12,208,197,11,0.947115385,,,
Ministry of Culture,2017,1,167,197,-30,1.179640719,,,
Ministry of Culture,2017,2,156,124,32,0.794871795,,,
Ministry of Culture,2017,3,181,186,-5,1.027624309,,,
Ministry of Culture,2017,4,238,173,65,0.726890756,,,
Ministry of Culture,2017,5,205,244,-39,1.190243902,,,
Ministry of Culture,2017,6,180,158,22,0.877777778,,,
Ministry of Culture,2017,7,182,244,-62,1.340659341,,,
Ministry of Culture,2017,8,178,164,14,0.921348315,,,
Ministry of Culture,2017,9,150,144,6,0.96,,,
Ministry of Culture,2017,10,154,161,-7,1.045454545,,,
Ministry of Culture,2017,11,166,131,35,0.789156627,,,
Ministry of Culture,2017,12,141,108,33,0.765957447,,,
Ministry of Culture,2018,1,149,191,-42,1.281879195,,,
Ministry of Culture,2018,2,112,100,12,0.892857143,,,
Ministry of Culture,2018,3,120,99,21,0.825,,,
Ministry of Culture,2018,4,137,65,72,0.474452555,,,
Ministry of Culture,2018,5,225,214,11,0.951111111,,,
Ministry of Culture,2018,6,138,122,16,0.884057971,,,
Ministry of Culture,2018,7,157,131,26,0.834394904,,,
Ministry of Culture,2018,8,166,151,15,0.909638554,,,
Ministry of Culture,2018,9,140,101,39,0.721428571,,,
Ministry of Culture,2018,10,191,348,-157,1.821989529,,,
Ministry of Culture,2018,11,159,112,47,0.704402516,,,
Ministry of Culture,2018,12,162,109,53,0.672839506,,,
Ministry of Culture,2019,1,191,107,84,0.560209424,,,
Ministry of Culture,2019,2,162,143,19,0.882716049,,,
Ministry of Culture,2019,3,159,91,68,0.572327044,,,
Ministry of Culture,2019,4,149,102,47,0.684563758,,,
Ministry of Culture,2019,5,120,53,67,0.441666667,,,
Ministry of Culture,2019,6,174,114,60,0.655172414,,,
Ministry of Culture,2019,7,178,370,-192,2.078651685,,,
Ministry of Culture,2019,8,221,154,67,0.696832579,,,
Ministry of Culture,2019,9,208,258,-50,1.240384615,,,
Ministry of Culture,2019,10,191,151,40,0.790575916,,,
Ministry of Culture,2019,11,11,23,-12,2.090909091,,,
Ministry of Development of North Eastern Region,2016,1,18,2,16,0.111111111,,,
Ministry of Development of North Eastern Region,2016,2,16,2,14,0.125,,,
Ministry of Development of North Eastern Region,2016,3,19,30,-11,1.578947368,,,
Ministry of Development of North Eastern Region,2016,4,17,8,9,0.470588235,,,
Ministry of Development of North Eastern Region,2016,5,19,1,18,0.052631579,,,
Ministry of Development of North Eastern Region,2016,6,25,14,11,0.56,,,
Ministry of Development of North Eastern Region,2016,7,22,69,-47,3.136363636,,,
Ministry of Development of North Eastern Region,2016,8,35,31,4,0.885714286,,,
Ministry of Development of North Eastern Region,2016,9,20,22,-2,1.1,,,
Ministry of Development of North Eastern Region,2016,10,17,12,5,0.705882353,,,
Ministry of Development of North Eastern Region,2016,11,19,7,12,0.368421053,,,
Ministry of Development of North Eastern Region,2016,12,37,16,21,0.432432432,,,
Ministry of Development of North Eastern Region,2017,1,14,39,-25,2.785714286,,,
Ministry of Development of North Eastern Region,2017,2,20,12,8,0.6,,,
Ministry of Development of North Eastern Region,2017,3,28,23,5,0.821428571,,,
Ministry of Development of North Eastern Region,2017,4,18,34,-16,1.888888889,,,
Ministry of Development of North Eastern Region,2017,5,27,29,-2,1.074074074,,,
Ministry of Development of North Eastern Region,2017,6,17,38,-21,2.235294118,,,
Ministry of Development of North Eastern Region,2017,7,22,19,3,0.863636364,,,
Ministry of Development of North Eastern Region,2017,8,25,23,2,0.92,,,
Ministry of Development of North Eastern Region,2017,9,12,11,1,0.916666667,,,
Ministry of Development of North Eastern Region,2017,10,15,9,6,0.6,,,
Ministry of Development of North Eastern Region,2017,11,23,13,10,0.565217391,,,
Ministry of Development of North Eastern Region,2017,12,18,20,-2,1.111111111,,,
Ministry of Development of North Eastern Region,2018,1,14,8,6,0.571428571,,,
Ministry of Development of North Eastern Region,2018,2,16,19,-3,1.1875,,,
Ministry of Development of North Eastern Region,2018,3,17,10,7,0.588235294,,,
Ministry of Development of North Eastern Region,2018,4,31,11,20,0.35483871,,,
Ministry of Development of North Eastern Region,2018,5,63,93,-30,1.476190476,,,
Ministry of Development of North Eastern Region,2018,6,43,49,-6,1.139534884,,,
Ministry of Development of North Eastern Region,2018,7,18,12,6,0.666666667,,,
Ministry of Development of North Eastern Region,2018,8,17,18,-1,1.058823529,,,
Ministry of Development of North Eastern Region,2018,9,9,8,1,0.888888889,,,
Ministry of Development of North Eastern Region,2018,10,18,14,4,0.777777778,,,
Ministry of Development of North Eastern Region,2018,11,15,16,-1,1.066666667,,,
Ministry of Development of North Eastern Region,2018,12,29,32,-3,1.103448276,,,
Ministry of Development of North Eastern Region,2019,1,45,42,3,0.933333333,,,
Ministry of Development of North Eastern Region,2019,2,34,13,21,0.382352941,,,
Ministry of Development of North Eastern Region,2019,3,43,58,-15,1.348837209,,,
Ministry of Development of North Eastern Region,2019,4,17,15,2,0.882352941,,,
Ministry of Development of North Eastern Region,2019,5,6,17,-11,2.833333333,,,
Ministry of Development of North Eastern Region,2019,6,16,1,15,0.0625,,,
Ministry of Development of North Eastern Region,2019,7,22,47,-25,2.136363636,,,
Ministry of Development of North Eastern Region,2019,8,21,23,-2,1.095238095,,,
Ministry of Development of North Eastern Region,2019,9,30,28,2,0.933333333,,,
Ministry of Development of North Eastern Region,2019,10,12,11,1,0.916666667,,,
Ministry of Drinking Water and Sanitation,2016,1,161,130,31,0.807453416,,,
Ministry of Drinking Water and Sanitation,2016,2,172,227,-55,1.319767442,,,
Ministry of Drinking Water and Sanitation,2016,3,191,214,-23,1.120418848,,,
Ministry of Drinking Water and Sanitation,2016,4,241,213,28,0.883817427,,,
Ministry of Drinking Water and Sanitation,2016,5,204,198,6,0.970588235,,,
Ministry of Drinking Water and Sanitation,2016,6,295,298,-3,1.010169492,,,
Ministry of Drinking Water and Sanitation,2016,7,182,178,4,0.978021978,,,
Ministry of Drinking Water and Sanitation,2016,8,272,199,73,0.731617647,,,
Ministry of Drinking Water and Sanitation,2016,9,223,201,22,0.901345291,,,
Ministry of Drinking Water and Sanitation,2016,10,228,246,-18,1.078947368,,,
Ministry of Drinking Water and Sanitation,2016,11,221,199,22,0.900452489,,,
Ministry of Drinking Water and Sanitation,2016,12,235,139,96,0.591489362,,,
Ministry of Drinking Water and Sanitation,2017,1,179,156,23,0.87150838,,,
Ministry of Drinking Water and Sanitation,2017,2,228,181,47,0.793859649,,,
Ministry of Drinking Water and Sanitation,2017,3,254,290,-36,1.141732283,,,
Ministry of Drinking Water and Sanitation,2017,4,226,269,-43,1.190265487,,,
Ministry of Drinking Water and Sanitation,2017,5,196,231,-35,1.178571429,,,
Ministry of Drinking Water and Sanitation,2017,6,181,220,-39,1.215469613,,,
Ministry of Drinking Water and Sanitation,2017,7,191,180,11,0.942408377,,,
Ministry of Drinking Water and Sanitation,2017,8,217,229,-12,1.055299539,,,
Ministry of Drinking Water and Sanitation,2017,9,180,191,-11,1.061111111,,,
Ministry of Drinking Water and Sanitation,2017,10,199,113,86,0.567839196,,,
Ministry of Drinking Water and Sanitation,2017,11,169,159,10,0.940828402,,,
Ministry of Drinking Water and Sanitation,2017,12,140,277,-137,1.978571429,,,
Ministry of Drinking Water and Sanitation,2018,1,121,187,-66,1.545454545,,,
Ministry of Drinking Water and Sanitation,2018,2,84,48,36,0.571428571,,,
Ministry of Drinking Water and Sanitation,2018,3,148,122,26,0.824324324,,,
Ministry of Drinking Water and Sanitation,2018,4,165,186,-21,1.127272727,,,
Ministry of Drinking Water and Sanitation,2018,5,249,238,11,0.955823293,,,
Ministry of Drinking Water and Sanitation,2018,6,179,135,44,0.754189944,,,
Ministry of Drinking Water and Sanitation,2018,7,184,226,-42,1.22826087,,,
Ministry of Drinking Water and Sanitation,2018,8,141,99,42,0.70212766,,,
Ministry of Drinking Water and Sanitation,2018,9,147,97,50,0.659863946,,,
Ministry of Drinking Water and Sanitation,2018,10,157,194,-37,1.23566879,,,
Ministry of Drinking Water and Sanitation,2018,11,122,48,74,0.393442623,,,
Ministry of Drinking Water and Sanitation,2018,12,142,99,43,0.697183099,,,
Ministry of Drinking Water and Sanitation,2019,1,130,43,87,0.330769231,,,
Ministry of Drinking Water and Sanitation,2019,2,145,158,-13,1.089655172,,,
Ministry of Drinking Water and Sanitation,2019,3,174,163,11,0.936781609,,,
Ministry of Drinking Water and Sanitation,2019,4,129,156,-27,1.209302326,,,
Ministry of Drinking Water and Sanitation,2019,5,166,105,61,0.63253012,,,
Ministry of Drinking Water and Sanitation,2019,6,405,331,74,0.817283951,,,
Ministry of Drinking Water and Sanitation,2019,7,414,366,48,0.884057971,,,
Ministry of Drinking Water and Sanitation,2019,8,288,321,-33,1.114583333,,,
Ministry of Drinking Water and Sanitation,2019,9,274,214,60,0.781021898,,,
Ministry of Drinking Water and Sanitation,2019,10,195,198,-3,1.015384615,,,
Ministry of Drinking Water and Sanitation,2019,11,4,3,1,0.75,,,
Ministry of Earth Sciences,2016,1,32,12,20,0.375,,,
Ministry of Earth Sciences,2016,2,39,35,4,0.897435897,,,
Ministry of Earth Sciences,2016,3,28,29,-1,1.035714286,,,
Ministry of Earth Sciences,2016,4,27,28,-1,1.037037037,,,
Ministry of Earth Sciences,2016,5,35,32,3,0.914285714,,,
Ministry of Earth Sciences,2016,6,35,35,0,1,,,
Ministry of Earth Sciences,2016,7,37,36,1,0.972972973,,,
Ministry of Earth Sciences,2016,8,26,38,-12,1.461538462,,,
Ministry of Earth Sciences,2016,9,46,28,18,0.608695652,,,
Ministry of Earth Sciences,2016,10,30,20,10,0.666666667,,,
Ministry of Earth Sciences,2016,11,37,28,9,0.756756757,,,
Ministry of Earth Sciences,2016,12,34,48,-14,1.411764706,,,
Ministry of Earth Sciences,2017,1,44,38,6,0.863636364,,,
Ministry of Earth Sciences,2017,2,47,30,17,0.638297872,,,
Ministry of Earth Sciences,2017,3,37,49,-12,1.324324324,,,
Ministry of Earth Sciences,2017,4,23,45,-22,1.956521739,,,
Ministry of Earth Sciences,2017,5,29,24,5,0.827586207,,,
Ministry of Earth Sciences,2017,6,34,24,10,0.705882353,,,
Ministry of Earth Sciences,2017,7,93,27,66,0.290322581,,,
Ministry of Earth Sciences,2017,8,75,120,-45,1.6,,,
Ministry of Earth Sciences,2017,9,45,62,-17,1.377777778,,,
Ministry of Earth Sciences,2017,10,35,33,2,0.942857143,,,
Ministry of Earth Sciences,2017,11,45,49,-4,1.088888889,,,
Ministry of Earth Sciences,2017,12,50,48,2,0.96,,,
Ministry of Earth Sciences,2018,1,32,41,-9,1.28125,,,
Ministry of Earth Sciences,2018,2,28,24,4,0.857142857,,,
Ministry of Earth Sciences,2018,3,60,46,14,0.766666667,,,
Ministry of Earth Sciences,2018,4,73,60,13,0.821917808,,,
Ministry of Earth Sciences,2018,5,100,117,-17,1.17,,,
Ministry of Earth Sciences,2018,6,36,22,14,0.611111111,,,
Ministry of Earth Sciences,2018,7,47,68,-21,1.446808511,,,
Ministry of Earth Sciences,2018,8,78,42,36,0.538461538,,,
Ministry of Earth Sciences,2018,9,42,65,-23,1.547619048,,,
Ministry of Earth Sciences,2018,10,42,66,-24,1.571428571,,,
Ministry of Earth Sciences,2018,11,28,28,0,1,,,
Ministry of Earth Sciences,2018,12,50,62,-12,1.24,,,
Ministry of Earth Sciences,2019,1,52,47,5,0.903846154,,,
Ministry of Earth Sciences,2019,2,41,20,21,0.487804878,,,
Ministry of Earth Sciences,2019,3,49,53,-4,1.081632653,,,
Ministry of Earth Sciences,2019,4,30,32,-2,1.066666667,,,
Ministry of Earth Sciences,2019,5,25,33,-8,1.32,,,
Ministry of Earth Sciences,2019,6,21,22,-1,1.047619048,,,
Ministry of Earth Sciences,2019,7,34,22,12,0.647058824,,,
Ministry of Earth Sciences,2019,8,21,48,-27,2.285714286,,,
Ministry of Earth Sciences,2019,9,29,23,6,0.793103448,,,
Ministry of Earth Sciences,2019,10,22,25,-3,1.136363636,,,
Ministry of Electronics & Information Technology,2016,1,257,173,84,0.673151751,,,
Ministry of Electronics & Information Technology,2016,2,313,324,-11,1.03514377,,,
Ministry of Electronics & Information Technology,2016,3,310,301,9,0.970967742,,,
Ministry of Electronics & Information Technology,2016,4,284,248,36,0.873239437,,,
Ministry of Electronics & Information Technology,2016,5,311,298,13,0.958199357,,,
Ministry of Electronics & Information Technology,2016,6,440,424,16,0.963636364,,,
Ministry of Electronics & Information Technology,2016,7,364,348,16,0.956043956,,,
Ministry of Electronics & Information Technology,2016,8,492,408,84,0.829268293,,,
Ministry of Electronics & Information Technology,2016,9,616,652,-36,1.058441558,,,
Ministry of Electronics & Information Technology,2016,10,437,395,42,0.90389016,,,
Ministry of Electronics & Information Technology,2016,11,399,441,-42,1.105263158,,,
Ministry of Electronics & Information Technology,2016,12,616,489,127,0.793831169,,,
Ministry of Electronics & Information Technology,2017,1,584,472,112,0.808219178,,,
Ministry of Electronics & Information Technology,2017,2,595,707,-112,1.188235294,,,
Ministry of Electronics & Information Technology,2017,3,644,643,1,0.998447205,,,
Ministry of Electronics & Information Technology,2017,4,552,607,-55,1.099637681,,,
Ministry of Electronics & Information Technology,2017,5,674,694,-20,1.029673591,,,
Ministry of Electronics & Information Technology,2017,6,612,564,48,0.921568627,,,
Ministry of Electronics & Information Technology,2017,7,693,631,62,0.910533911,,,
Ministry of Electronics & Information Technology,2017,8,688,776,-88,1.127906977,,,
Ministry of Electronics & Information Technology,2017,9,540,584,-44,1.081481481,,,
Ministry of Electronics & Information Technology,2017,10,556,518,38,0.931654676,,,
Ministry of Electronics & Information Technology,2017,11,548,482,66,0.879562044,,,
Ministry of Electronics & Information Technology,2017,12,553,574,-21,1.037974684,,,
Ministry of Electronics & Information Technology,2018,1,471,508,-37,1.078556263,,,
Ministry of Electronics & Information Technology,2018,2,414,391,23,0.944444444,,,
Ministry of Electronics & Information Technology,2018,3,493,408,85,0.827586207,,,
Ministry of Electronics & Information Technology,2018,4,500,596,-96,1.192,,,
Ministry of Electronics & Information Technology,2018,5,505,583,-78,1.154455446,,,
Ministry of Electronics & Information Technology,2018,6,454,401,53,0.883259912,,,
Ministry of Electronics & Information Technology,2018,7,631,655,-24,1.038034865,,,
Ministry of Electronics & Information Technology,2018,8,654,512,142,0.782874618,,,
Ministry of Electronics & Information Technology,2018,9,528,605,-77,1.145833333,,,
Ministry of Electronics & Information Technology,2018,10,460,542,-82,1.17826087,,,
Ministry of Electronics & Information Technology,2018,11,418,416,2,0.995215311,,,
Ministry of Electronics & Information Technology,2018,12,429,425,4,0.990675991,,,
Ministry of Electronics & Information Technology,2019,1,527,462,65,0.876660342,,,
Ministry of Electronics & Information Technology,2019,2,596,531,65,0.890939597,,,
Ministry of Electronics & Information Technology,2019,3,668,584,84,0.874251497,,,
Ministry of Electronics & Information Technology,2019,4,500,587,-87,1.174,,,
Ministry of Electronics & Information Technology,2019,5,459,571,-112,1.244008715,,,
Ministry of Electronics & Information Technology,2019,6,592,441,151,0.744932432,,,
Ministry of Electronics & Information Technology,2019,7,689,507,182,0.735849057,,,
Ministry of Electronics & Information Technology,2019,8,631,575,56,0.911251981,,,
Ministry of Electronics & Information Technology,2019,9,770,864,-94,1.122077922,,,
Ministry of Electronics & Information Technology,2019,10,559,578,-19,1.033989267,,,
Ministry of Electronics & Information Technology,2019,11,16,14,2,0.875,,,
"Ministry of Environment, Forest and Climate Change",2016,1,532,369,163,0.693609023,,,
"Ministry of Environment, Forest and Climate Change",2016,2,438,361,77,0.824200913,,,
"Ministry of Environment, Forest and Climate Change",2016,3,430,338,92,0.786046512,,,
"Ministry of Environment, Forest and Climate Change",2016,4,566,515,51,0.909893993,,,
"Ministry of Environment, Forest and Climate Change",2016,5,493,387,106,0.784989858,,,
"Ministry of Environment, Forest and Climate Change",2016,6,705,378,327,0.536170213,,,
"Ministry of Environment, Forest and Climate Change",2016,7,479,749,-270,1.563674322,,,
"Ministry of Environment, Forest and Climate Change",2016,8,550,627,-77,1.14,,,
"Ministry of Environment, Forest and Climate Change",2016,9,563,537,26,0.953818828,,,
"Ministry of Environment, Forest and Climate Change",2016,10,472,351,121,0.743644068,,,
"Ministry of Environment, Forest and Climate Change",2016,11,806,396,410,0.491315136,,,
"Ministry of Environment, Forest and Climate Change",2016,12,688,789,-101,1.146802326,,,
"Ministry of Environment, Forest and Climate Change",2017,1,591,724,-133,1.225042301,,,
"Ministry of Environment, Forest and Climate Change",2017,2,483,332,151,0.6873706,,,
"Ministry of Environment, Forest and Climate Change",2017,3,605,941,-336,1.555371901,,,
"Ministry of Environment, Forest and Climate Change",2017,4,604,701,-97,1.160596026,,,
"Ministry of Environment, Forest and Climate Change",2017,5,590,706,-116,1.196610169,,,
"Ministry of Environment, Forest and Climate Change",2017,6,529,460,69,0.869565217,,,
"Ministry of Environment, Forest and Climate Change",2017,7,389,351,38,0.902313625,,,
"Ministry of Environment, Forest and Climate Change",2017,8,476,480,-4,1.008403361,,,
"Ministry of Environment, Forest and Climate Change",2017,9,402,388,14,0.965174129,,,
"Ministry of Environment, Forest and Climate Change",2017,10,372,393,-21,1.056451613,,,
"Ministry of Environment, Forest and Climate Change",2017,11,631,665,-34,1.053882726,,,
"Ministry of Environment, Forest and Climate Change",2017,12,466,520,-54,1.115879828,,,
"Ministry of Environment, Forest and Climate Change",2018,1,429,544,-115,1.268065268,,,
"Ministry of Environment, Forest and Climate Change",2018,2,273,294,-21,1.076923077,,,
"Ministry of Environment, Forest and Climate Change",2018,3,402,313,89,0.778606965,,,
"Ministry of Environment, Forest and Climate Change",2018,4,352,323,29,0.917613636,,,
"Ministry of Environment, Forest and Climate Change",2018,5,633,515,118,0.813586098,,,
"Ministry of Environment, Forest and Climate Change",2018,6,579,476,103,0.822107081,,,
"Ministry of Environment, Forest and Climate Change",2018,7,753,1150,-397,1.527224436,,,
"Ministry of Environment, Forest and Climate Change",2018,8,449,408,41,0.908685969,,,
"Ministry of Environment, Forest and Climate Change",2018,9,359,283,76,0.788300836,,,
"Ministry of Environment, Forest and Climate Change",2018,10,548,432,116,0.788321168,,,
"Ministry of Environment, Forest and Climate Change",2018,11,466,281,185,0.603004292,,,
"Ministry of Environment, Forest and Climate Change",2018,12,416,626,-210,1.504807692,,,
"Ministry of Environment, Forest and Climate Change",2019,1,445,484,-39,1.087640449,,,
"Ministry of Environment, Forest and Climate Change",2019,2,365,511,-146,1.4,,,
"Ministry of Environment, Forest and Climate Change",2019,3,408,284,124,0.696078431,,,
"Ministry of Environment, Forest and Climate Change",2019,4,314,316,-2,1.006369427,,,
"Ministry of Environment, Forest and Climate Change",2019,5,455,495,-40,1.087912088,,,
"Ministry of Environment, Forest and Climate Change",2019,6,698,450,248,0.64469914,,,
"Ministry of Environment, Forest and Climate Change",2019,7,721,707,14,0.980582524,,,
"Ministry of Environment, Forest and Climate Change",2019,8,583,619,-36,1.061749571,,,
"Ministry of Environment, Forest and Climate Change",2019,9,758,643,115,0.84828496,,,
"Ministry of Environment, Forest and Climate Change",2019,10,613,911,-298,1.486133768,,,
"Ministry of Environment, Forest and Climate Change",2019,11,34,22,12,0.647058824,,,
Ministry of External Affairs,2016,1,770,360,410,0.467532468,,,
Ministry of External Affairs,2016,2,862,958,-96,1.11136891,,,
Ministry of External Affairs,2016,3,984,913,71,0.927845528,,,
Ministry of External Affairs,2016,4,1034,1098,-64,1.061895551,,,
Ministry of External Affairs,2016,5,943,943,0,1,,,
Ministry of External Affairs,2016,6,1278,1251,27,0.978873239,,,
Ministry of External Affairs,2016,7,1057,1188,-131,1.123935667,,,
Ministry of External Affairs,2016,8,1143,1063,80,0.930008749,,,
Ministry of External Affairs,2016,9,1028,1049,-21,1.020428016,,,
Ministry of External Affairs,2016,10,909,915,-6,1.00660066,,,
Ministry of External Affairs,2016,11,935,936,-1,1.001069519,,,
Ministry of External Affairs,2016,12,1214,1159,55,0.954695222,,,
Ministry of External Affairs,2017,1,964,971,-7,1.007261411,,,
Ministry of External Affairs,2017,2,905,975,-70,1.077348066,,,
Ministry of External Affairs,2017,3,1192,1167,25,0.979026846,,,
Ministry of External Affairs,2017,4,2933,2761,172,0.941356972,,,
Ministry of External Affairs,2017,5,1196,1391,-195,1.163043478,,,
Ministry of External Affairs,2017,6,972,860,112,0.884773663,,,
Ministry of External Affairs,2017,7,1100,1221,-121,1.11,,,
Ministry of External Affairs,2017,8,963,1030,-67,1.069574247,,,
Ministry of External Affairs,2017,9,811,872,-61,1.075215783,,,
Ministry of External Affairs,2017,10,688,631,57,0.917151163,,,
Ministry of External Affairs,2017,11,829,844,-15,1.018094089,,,
Ministry of External Affairs,2017,12,666,672,-6,1.009009009,,,
Ministry of External Affairs,2018,1,624,586,38,0.939102564,,,
Ministry of External Affairs,2018,2,555,602,-47,1.084684685,,,
Ministry of External Affairs,2018,3,807,696,111,0.862453532,,,
Ministry of External Affairs,2018,4,862,785,77,0.910672854,,,
Ministry of External Affairs,2018,5,1039,1047,-8,1.007699711,,,
Ministry of External Affairs,2018,6,686,718,-32,1.04664723,,,
Ministry of External Affairs,2018,7,950,913,37,0.961052632,,,
Ministry of External Affairs,2018,8,782,533,249,0.681585678,,,
Ministry of External Affairs,2018,9,832,948,-116,1.139423077,,,
Ministry of External Affairs,2018,10,926,869,57,0.938444924,,,
Ministry of External Affairs,2018,11,816,735,81,0.900735294,,,
Ministry of External Affairs,2018,12,925,928,-3,1.003243243,,,
Ministry of External Affairs,2019,1,957,971,-14,1.014629049,,,
Ministry of External Affairs,2019,2,940,942,-2,1.00212766,,,
Ministry of External Affairs,2019,3,1000,759,241,0.759,,,
Ministry of External Affairs,2019,4,810,1183,-373,1.460493827,,,
Ministry of External Affairs,2019,5,826,900,-74,1.089588378,,,
Ministry of External Affairs,2019,6,946,801,145,0.846723044,,,
Ministry of External Affairs,2019,7,1115,1224,-109,1.097757848,,,
Ministry of External Affairs,2019,8,1112,1193,-81,1.072841727,,,
Ministry of External Affairs,2019,9,1272,1172,100,0.921383648,,,
Ministry of External Affairs,2019,10,1174,1069,105,0.910562181,,,
Ministry of External Affairs,2019,11,30,39,-9,1.3,,,
Ministry of Food Processing Industries,2016,1,36,10,26,0.277777778,,,
Ministry of Food Processing Industries,2016,2,37,36,1,0.972972973,,,
Ministry of Food Processing Industries,2016,3,35,52,-17,1.485714286,,,
Ministry of Food Processing Industries,2016,4,51,27,24,0.529411765,,,
Ministry of Food Processing Industries,2016,5,36,42,-6,1.166666667,,,
Ministry of Food Processing Industries,2016,6,65,54,11,0.830769231,,,
Ministry of Food Processing Industries,2016,7,49,29,20,0.591836735,,,
Ministry of Food Processing Industries,2016,8,39,69,-30,1.769230769,,,
Ministry of Food Processing Industries,2016,9,31,19,12,0.612903226,,,
Ministry of Food Processing Industries,2016,10,40,38,2,0.95,,,
Ministry of Food Processing Industries,2016,11,35,50,-15,1.428571429,,,
Ministry of Food Processing Industries,2016,12,36,25,11,0.694444444,,,
Ministry of Food Processing Industries,2017,1,46,52,-6,1.130434783,,,
Ministry of Food Processing Industries,2017,2,30,28,2,0.933333333,,,
Ministry of Food Processing Industries,2017,3,46,42,4,0.913043478,,,
Ministry of Food Processing Industries,2017,4,27,19,8,0.703703704,,,
Ministry of Food Processing Industries,2017,5,44,40,4,0.909090909,,,
Ministry of Food Processing Industries,2017,6,41,58,-17,1.414634146,,,
Ministry of Food Processing Industries,2017,7,46,42,4,0.913043478,,,
Ministry of Food Processing Industries,2017,8,34,57,-23,1.676470588,,,
Ministry of Food Processing Industries,2017,9,49,48,1,0.979591837,,,
Ministry of Food Processing Industries,2017,10,39,17,22,0.435897436,,,
Ministry of Food Processing Industries,2017,11,42,45,-3,1.071428571,,,
Ministry of Food Processing Industries,2017,12,41,28,13,0.682926829,,,
Ministry of Food Processing Industries,2018,1,40,52,-12,1.3,,,
Ministry of Food Processing Industries,2018,2,26,25,1,0.961538462,,,
Ministry of Food Processing Industries,2018,3,29,36,-7,1.24137931,,,
Ministry of Food Processing Industries,2018,4,44,38,6,0.863636364,,,
Ministry of Food Processing Industries,2018,5,80,102,-22,1.275,,,
Ministry of Food Processing Industries,2018,6,25,20,5,0.8,,,
Ministry of Food Processing Industries,2018,7,34,25,9,0.735294118,,,
Ministry of Food Processing Industries,2018,8,33,35,-2,1.060606061,,,
Ministry of Food Processing Industries,2018,9,72,29,43,0.402777778,,,
Ministry of Food Processing Industries,2018,10,47,76,-29,1.617021277,,,
Ministry of Food Processing Industries,2018,11,23,56,-33,2.434782609,,,
Ministry of Food Processing Industries,2018,12,40,27,13,0.675,,,
Ministry of Food Processing Industries,2019,1,63,78,-15,1.238095238,,,
Ministry of Food Processing Industries,2019,2,51,46,5,0.901960784,,,
Ministry of Food Processing Industries,2019,3,56,54,2,0.964285714,,,
Ministry of Food Processing Industries,2019,4,22,31,-9,1.409090909,,,
Ministry of Food Processing Industries,2019,5,36,34,2,0.944444444,,,
Ministry of Food Processing Industries,2019,6,50,28,22,0.56,,,
Ministry of Food Processing Industries,2019,7,43,60,-17,1.395348837,,,
Ministry of Food Processing Industries,2019,8,56,55,1,0.982142857,,,
Ministry of Food Processing Industries,2019,9,41,43,-2,1.048780488,,,
Ministry of Food Processing Industries,2019,10,35,35,0,1,,,
Ministry of Home Affairs,2016,1,2170,551,1619,0.253917051,,,
Ministry of Home Affairs,2016,2,2076,902,1174,0.434489403,,,
Ministry of Home Affairs,2016,3,1962,1831,131,0.933231397,,,
Ministry of Home Affairs,2016,4,1629,1007,622,0.618170657,,,
Ministry of Home Affairs,2016,5,1585,1273,312,0.803154574,,,
Ministry of Home Affairs,2016,6,1895,2487,-592,1.312401055,,,
Ministry of Home Affairs,2016,7,2101,2677,-576,1.274155164,,,
Ministry of Home Affairs,2016,8,2986,2460,526,0.823844608,,,
Ministry of Home Affairs,2016,9,2577,1908,669,0.740395809,,,
Ministry of Home Affairs,2016,10,2242,2100,142,0.936663693,,,
Ministry of Home Affairs,2016,11,1743,1691,52,0.97016638,,,
Ministry of Home Affairs,2016,12,2352,2044,308,0.869047619,,,
Ministry of Home Affairs,2017,1,2053,2058,-5,1.00243546,,,
Ministry of Home Affairs,2017,2,1640,893,747,0.544512195,,,
Ministry of Home Affairs,2017,3,2145,2489,-344,1.16037296,,,
Ministry of Home Affairs,2017,4,2221,3549,-1328,1.597928861,,,
Ministry of Home Affairs,2017,5,2311,2617,-306,1.132410212,,,
Ministry of Home Affairs,2017,6,1946,1623,323,0.834018499,,,
Ministry of Home Affairs,2017,7,2081,1348,733,0.647765497,,,
Ministry of Home Affairs,2017,8,4683,2187,2496,0.467008328,,,
Ministry of Home Affairs,2017,9,2169,2918,-749,1.345320424,,,
Ministry of Home Affairs,2017,10,3678,3465,213,0.942088091,,,
Ministry of Home Affairs,2017,11,1669,3933,-2264,2.356500899,,,
Ministry of Home Affairs,2017,12,1683,2042,-359,1.213309566,,,
Ministry of Home Affairs,2018,1,1287,1111,176,0.863247863,,,
Ministry of Home Affairs,2018,2,1502,3034,-1532,2.019973369,,,
Ministry of Home Affairs,2018,3,1971,1178,793,0.597666159,,,
Ministry of Home Affairs,2018,4,1980,1648,332,0.832323232,,,
Ministry of Home Affairs,2018,5,3249,1898,1351,0.584179748,,,
Ministry of Home Affairs,2018,6,2997,787,2210,0.262595929,,,
Ministry of Home Affairs,2018,7,2414,2373,41,0.983015742,,,
Ministry of Home Affairs,2018,8,3289,3212,77,0.976588629,,,
Ministry of Home Affairs,2018,9,2850,2577,273,0.904210526,,,
Ministry of Home Affairs,2018,10,3063,2909,154,0.949722494,,,
Ministry of Home Affairs,2018,11,2169,2143,26,0.988012909,,,
Ministry of Home Affairs,2018,12,2109,1639,470,0.777145567,,,
Ministry of Home Affairs,2019,1,2201,2225,-24,1.010904134,,,
Ministry of Home Affairs,2019,2,2281,3135,-854,1.374397194,,,
Ministry of Home Affairs,2019,3,2604,2395,209,0.919738863,,,
Ministry of Home Affairs,2019,4,1669,2402,-733,1.439185141,,,
Ministry of Home Affairs,2019,5,1810,2458,-648,1.35801105,,,
Ministry of Home Affairs,2019,6,2230,1792,438,0.803587444,,,
Ministry of Home Affairs,2019,7,2790,1101,1689,0.394623656,,,
Ministry of Home Affairs,2019,8,2984,1056,1928,0.353887399,,,
Ministry of Home Affairs,2019,9,3183,3713,-530,1.166509582,,,
Ministry of Home Affairs,2019,10,2970,4610,-1640,1.552188552,,,
Ministry of Home Affairs,2019,11,87,91,-4,1.045977011,,,
Ministry of Housing and Urban Affairs,2016,1,760,413,347,0.543421053,,,
Ministry of Housing and Urban Affairs,2016,2,702,549,153,0.782051282,,,
Ministry of Housing and Urban Affairs,2016,3,776,657,119,0.846649485,,,
Ministry of Housing and Urban Affairs,2016,4,804,730,74,0.907960199,,,
Ministry of Housing and Urban Affairs,2016,5,819,824,-5,1.006105006,,,
Ministry of Housing and Urban Affairs,2016,6,933,945,-12,1.012861736,,,
Ministry of Housing and Urban Affairs,2016,7,829,762,67,0.919179735,,,
Ministry of Housing and Urban Affairs,2016,8,1070,1011,59,0.944859813,,,
Ministry of Housing and Urban Affairs,2016,9,948,854,94,0.900843882,,,
Ministry of Housing and Urban Affairs,2016,10,859,757,102,0.881257276,,,
Ministry of Housing and Urban Affairs,2016,11,743,748,-5,1.006729475,,,
Ministry of Housing and Urban Affairs,2016,12,1101,947,154,0.860127157,,,
Ministry of Housing and Urban Affairs,2017,1,1061,1321,-260,1.245051838,,,
Ministry of Housing and Urban Affairs,2017,2,1133,1123,10,0.991173875,,,
Ministry of Housing and Urban Affairs,2017,3,1405,1638,-233,1.165836299,,,
Ministry of Housing and Urban Affairs,2017,4,1203,1060,143,0.881130507,,,
Ministry of Housing and Urban Affairs,2017,5,1558,1594,-36,1.023106547,,,
Ministry of Housing and Urban Affairs,2017,6,1358,1464,-106,1.078055965,,,
Ministry of Housing and Urban Affairs,2017,7,1259,1318,-59,1.046862589,,,
Ministry of Housing and Urban Affairs,2017,8,1237,1091,146,0.881972514,,,
Ministry of Housing and Urban Affairs,2017,9,1089,993,96,0.91184573,,,
Ministry of Housing and Urban Affairs,2017,10,951,1014,-63,1.066246057,,,
Ministry of Housing and Urban Affairs,2017,11,966,931,35,0.963768116,,,
Ministry of Housing and Urban Affairs,2017,12,944,1003,-59,1.0625,,,
Ministry of Housing and Urban Affairs,2018,1,741,783,-42,1.056680162,,,
Ministry of Housing and Urban Affairs,2018,2,711,1002,-291,1.4092827,,,
Ministry of Housing and Urban Affairs,2018,3,933,671,262,0.719185423,,,
Ministry of Housing and Urban Affairs,2018,4,869,843,26,0.970080552,,,
Ministry of Housing and Urban Affairs,2018,5,1132,1280,-148,1.130742049,,,
Ministry of Housing and Urban Affairs,2018,6,962,943,19,0.98024948,,,
Ministry of Housing and Urban Affairs,2018,7,1255,989,266,0.788047809,,,
Ministry of Housing and Urban Affairs,2018,8,1004,1176,-172,1.171314741,,,
Ministry of Housing and Urban Affairs,2018,9,1021,827,194,0.809990206,,,
Ministry of Housing and Urban Affairs,2018,10,1193,1458,-265,1.222129086,,,
Ministry of Housing and Urban Affairs,2018,11,1020,958,62,0.939215686,,,
Ministry of Housing and Urban Affairs,2018,12,747,780,-33,1.044176707,,,
Ministry of Housing and Urban Affairs,2019,1,922,919,3,0.996746204,,,
Ministry of Housing and Urban Affairs,2019,2,941,750,191,0.797024442,,,
Ministry of Housing and Urban Affairs,2019,3,986,1123,-137,1.138945233,,,
Ministry of Housing and Urban Affairs,2019,4,907,810,97,0.893054024,,,
Ministry of Housing and Urban Affairs,2019,5,904,967,-63,1.069690265,,,
Ministry of Housing and Urban Affairs,2019,6,1341,1239,102,0.92393736,,,
Ministry of Housing and Urban Affairs,2019,7,1317,1332,-15,1.011389522,,,
Ministry of Housing and Urban Affairs,2019,8,1162,888,274,0.764199656,,,
Ministry of Housing and Urban Affairs,2019,9,1309,1270,39,0.970206264,,,
Ministry of Housing and Urban Affairs,2019,10,960,1043,-83,1.086458333,,,
Ministry of Housing and Urban Affairs,2019,11,23,27,-4,1.173913043,,,
Ministry of Information and Broadcasting,2016,1,582,116,466,0.199312715,,,
Ministry of Information and Broadcasting,2016,2,582,715,-133,1.228522337,,,
Ministry of Information and Broadcasting,2016,3,560,434,126,0.775,,,
Ministry of Information and Broadcasting,2016,4,503,409,94,0.813121272,,,
Ministry of Information and Broadcasting,2016,5,520,458,62,0.880769231,,,
Ministry of Information and Broadcasting,2016,6,709,606,103,0.854724965,,,
Ministry of Information and Broadcasting,2016,7,633,848,-215,1.339652449,,,
Ministry of Information and Broadcasting,2016,8,710,679,31,0.956338028,,,
Ministry of Information and Broadcasting,2016,9,608,556,52,0.914473684,,,
Ministry of Information and Broadcasting,2016,10,572,629,-57,1.09965035,,,
Ministry of Information and Broadcasting,2016,11,540,481,59,0.890740741,,,
Ministry of Information and Broadcasting,2016,12,697,634,63,0.909612626,,,
Ministry of Information and Broadcasting,2017,1,747,582,165,0.779116466,,,
Ministry of Information and Broadcasting,2017,2,540,552,-12,1.022222222,,,
Ministry of Information and Broadcasting,2017,3,583,782,-199,1.341337907,,,
Ministry of Information and Broadcasting,2017,4,463,409,54,0.88336933,,,
Ministry of Information and Broadcasting,2017,5,619,611,8,0.987075929,,,
Ministry of Information and Broadcasting,2017,6,520,524,-4,1.007692308,,,
Ministry of Information and Broadcasting,2017,7,524,576,-52,1.099236641,,,
Ministry of Information and Broadcasting,2017,8,597,650,-53,1.088777219,,,
Ministry of Information and Broadcasting,2017,9,602,484,118,0.803986711,,,
Ministry of Information and Broadcasting,2017,10,587,442,145,0.752981261,,,
Ministry of Information and Broadcasting,2017,11,627,492,135,0.784688995,,,
Ministry of Information and Broadcasting,2017,12,563,748,-185,1.328596803,,,
Ministry of Information and Broadcasting,2018,1,475,468,7,0.985263158,,,
Ministry of Information and Broadcasting,2018,2,410,659,-249,1.607317073,,,
Ministry of Information and Broadcasting,2018,3,568,573,-5,1.008802817,,,
Ministry of Information and Broadcasting,2018,4,614,658,-44,1.071661238,,,
Ministry of Information and Broadcasting,2018,5,746,621,125,0.832439678,,,
Ministry of Information and Broadcasting,2018,6,493,381,112,0.772819473,,,
Ministry of Information and Broadcasting,2018,7,779,684,95,0.87804878,,,
Ministry of Information and Broadcasting,2018,8,692,674,18,0.973988439,,,
Ministry of Information and Broadcasting,2018,9,627,376,251,0.599681021,,,
Ministry of Information and Broadcasting,2018,10,635,596,39,0.938582677,,,
Ministry of Information and Broadcasting,2018,11,600,675,-75,1.125,,,
Ministry of Information and Broadcasting,2018,12,564,516,48,0.914893617,,,
Ministry of Information and Broadcasting,2019,1,739,819,-80,1.108254398,,,
Ministry of Information and Broadcasting,2019,2,1300,1110,190,0.853846154,,,
Ministry of Information and Broadcasting,2019,3,1089,1276,-187,1.171717172,,,
Ministry of Information and Broadcasting,2019,4,957,1115,-158,1.165099269,,,
Ministry of Information and Broadcasting,2019,5,769,892,-123,1.159947984,,,
Ministry of Information and Broadcasting,2019,6,1073,1046,27,0.974836906,,,
Ministry of Information and Broadcasting,2019,7,970,930,40,0.958762887,,,
Ministry of Information and Broadcasting,2019,8,825,547,278,0.663030303,,,
Ministry of Information and Broadcasting,2019,9,777,1059,-282,1.362934363,,,
Ministry of Information and Broadcasting,2019,10,526,706,-180,1.342205323,,,
Ministry of Information and Broadcasting,2019,11,17,10,7,0.588235294,,,
Ministry of Labour and Employment,2016,1,1794,546,1248,0.304347826,,,
Ministry of Labour and Employment,2016,2,2222,2638,-416,1.187218722,,,
Ministry of Labour and Employment,2016,3,2514,2615,-101,1.04017502,,,
Ministry of Labour and Employment,2016,4,1810,1826,-16,1.008839779,,,
Ministry of Labour and Employment,2016,5,1628,1662,-34,1.020884521,,,
Ministry of Labour and Employment,2016,6,1961,1810,151,0.92299847,,,
Ministry of Labour and Employment,2016,7,1729,1657,72,0.958357432,,,
Ministry of Labour and Employment,2016,8,2178,1726,452,0.792470156,,,
Ministry of Labour and Employment,2016,9,2136,1921,215,0.899344569,,,
Ministry of Labour and Employment,2016,10,2094,2257,-163,1.077841452,,,
Ministry of Labour and Employment,2016,11,1778,2144,-366,1.205849269,,,
Ministry of Labour and Employment,2016,12,2462,2492,-30,1.012185215,,,
Ministry of Labour and Employment,2017,1,2205,2242,-37,1.016780045,,,
Ministry of Labour and Employment,2017,2,2285,2355,-70,1.030634573,,,
Ministry of Labour and Employment,2017,3,3018,2708,310,0.897282969,,,
Ministry of Labour and Employment,2017,4,2807,2590,217,0.922693267,,,
Ministry of Labour and Employment,2017,5,3040,3150,-110,1.036184211,,,
Ministry of Labour and Employment,2017,6,2644,2778,-134,1.050680787,,,
Ministry of Labour and Employment,2017,7,3071,2703,368,0.880169326,,,
Ministry of Labour and Employment,2017,8,3172,3433,-261,1.082282472,,,
Ministry of Labour and Employment,2017,9,2601,2471,130,0.950019223,,,
Ministry of Labour and Employment,2017,10,2442,2724,-282,1.115479115,,,
Ministry of Labour and Employment,2017,11,2948,2701,247,0.916214383,,,
Ministry of Labour and Employment,2017,12,2757,2779,-22,1.007979688,,,
Ministry of Labour and Employment,2018,1,2439,2642,-203,1.083230832,,,
Ministry of Labour and Employment,2018,2,2264,2741,-477,1.210689046,,,
Ministry of Labour and Employment,2018,3,2970,2643,327,0.88989899,,,
Ministry of Labour and Employment,2018,4,2778,2711,67,0.975881929,,,
Ministry of Labour and Employment,2018,5,3762,3333,429,0.885964912,,,
Ministry of Labour and Employment,2018,6,2511,2390,121,0.951812027,,,
Ministry of Labour and Employment,2018,7,3803,3646,157,0.958716803,,,
Ministry of Labour and Employment,2018,8,3258,3822,-564,1.173112339,,,
Ministry of Labour and Employment,2018,9,2814,2739,75,0.973347548,,,
Ministry of Labour and Employment,2018,10,3142,3464,-322,1.102482495,,,
Ministry of Labour and Employment,2018,11,2497,2647,-150,1.060072087,,,
Ministry of Labour and Employment,2018,12,2855,2551,304,0.89352014,,,
Ministry of Labour and Employment,2019,1,3633,3759,-126,1.034682081,,,
Ministry of Labour and Employment,2019,2,3497,3372,125,0.964255076,,,
Ministry of Labour and Employment,2019,3,3462,3489,-27,1.00779896,,,
Ministry of Labour and Employment,2019,4,3202,3085,117,0.963460337,,,
Ministry of Labour and Employment,2019,5,3242,3344,-102,1.03146206,,,
Ministry of Labour and Employment,2019,6,4267,3959,308,0.927818139,,,
Ministry of Labour and Employment,2019,7,4632,4335,297,0.935880829,,,
Ministry of Labour and Employment,2019,8,3878,3671,207,0.94662197,,,
Ministry of Labour and Employment,2019,9,4510,4773,-263,1.058314856,,,
Ministry of Labour and Employment,2019,10,4416,4860,-444,1.100543478,,,
Ministry of Labour and Employment,2019,11,155,176,-21,1.135483871,,,
Ministry of Micro Small and Medium  Enterprises,2016,1,154,78,76,0.506493506,,,
Ministry of Micro Small and Medium  Enterprises,2016,2,219,220,-1,1.00456621,,,
Ministry of Micro Small and Medium  Enterprises,2016,3,185,226,-41,1.221621622,,,
Ministry of Micro Small and Medium  Enterprises,2016,4,141,151,-10,1.070921986,,,
Ministry of Micro Small and Medium  Enterprises,2016,5,133,135,-2,1.015037594,,,
Ministry of Micro Small and Medium  Enterprises,2016,6,185,172,13,0.92972973,,,
Ministry of Micro Small and Medium  Enterprises,2016,7,200,199,1,0.995,,,
Ministry of Micro Small and Medium  Enterprises,2016,8,178,163,15,0.915730337,,,
Ministry of Micro Small and Medium  Enterprises,2016,9,193,215,-22,1.113989637,,,
Ministry of Micro Small and Medium  Enterprises,2016,10,153,128,25,0.836601307,,,
Ministry of Micro Small and Medium  Enterprises,2016,11,148,143,5,0.966216216,,,
Ministry of Micro Small and Medium  Enterprises,2016,12,191,165,26,0.863874346,,,
Ministry of Micro Small and Medium  Enterprises,2017,1,198,209,-11,1.055555556,,,
Ministry of Micro Small and Medium  Enterprises,2017,2,176,173,3,0.982954545,,,
Ministry of Micro Small and Medium  Enterprises,2017,3,262,284,-22,1.083969466,,,
Ministry of Micro Small and Medium  Enterprises,2017,4,142,125,17,0.88028169,,,
Ministry of Micro Small and Medium  Enterprises,2017,5,210,216,-6,1.028571429,,,
Ministry of Micro Small and Medium  Enterprises,2017,6,227,261,-34,1.149779736,,,
Ministry of Micro Small and Medium  Enterprises,2017,7,243,247,-4,1.016460905,,,
Ministry of Micro Small and Medium  Enterprises,2017,8,185,162,23,0.875675676,,,
Ministry of Micro Small and Medium  Enterprises,2017,9,206,195,11,0.946601942,,,
Ministry of Micro Small and Medium  Enterprises,2017,10,149,156,-7,1.046979866,,,
Ministry of Micro Small and Medium  Enterprises,2017,11,208,171,37,0.822115385,,,
Ministry of Micro Small and Medium  Enterprises,2017,12,182,217,-35,1.192307692,,,
Ministry of Micro Small and Medium  Enterprises,2018,1,154,161,-7,1.045454545,,,
Ministry of Micro Small and Medium  Enterprises,2018,2,144,111,33,0.770833333,,,
Ministry of Micro Small and Medium  Enterprises,2018,3,137,152,-15,1.109489051,,,
Ministry of Micro Small and Medium  Enterprises,2018,4,185,164,21,0.886486486,,,
Ministry of Micro Small and Medium  Enterprises,2018,5,257,240,17,0.93385214,,,
Ministry of Micro Small and Medium  Enterprises,2018,6,193,147,46,0.761658031,,,
Ministry of Micro Small and Medium  Enterprises,2018,7,179,188,-9,1.05027933,,,
Ministry of Micro Small and Medium  Enterprises,2018,8,174,162,12,0.931034483,,,
Ministry of Micro Small and Medium  Enterprises,2018,9,191,187,4,0.979057592,,,
Ministry of Micro Small and Medium  Enterprises,2018,10,170,156,14,0.917647059,,,
Ministry of Micro Small and Medium  Enterprises,2018,11,197,211,-14,1.07106599,,,
Ministry of Micro Small and Medium  Enterprises,2018,12,239,217,22,0.907949791,,,
Ministry of Micro Small and Medium  Enterprises,2019,1,215,189,26,0.879069767,,,
Ministry of Micro Small and Medium  Enterprises,2019,2,150,271,-121,1.806666667,,,
Ministry of Micro Small and Medium  Enterprises,2019,3,201,170,31,0.845771144,,,
Ministry of Micro Small and Medium  Enterprises,2019,4,128,175,-47,1.3671875,,,
Ministry of Micro Small and Medium  Enterprises,2019,5,108,78,30,0.722222222,,,
Ministry of Micro Small and Medium  Enterprises,2019,6,229,171,58,0.746724891,,,
Ministry of Micro Small and Medium  Enterprises,2019,7,263,311,-48,1.182509506,,,
Ministry of Micro Small and Medium  Enterprises,2019,8,243,187,56,0.769547325,,,
Ministry of Micro Small and Medium  Enterprises,2019,9,281,258,23,0.918149466,,,
Ministry of Micro Small and Medium  Enterprises,2019,10,208,170,38,0.817307692,,,
Ministry of Micro Small and Medium  Enterprises,2019,11,7,7,0,1,,,
Ministry of Mines,2016,1,60,27,33,0.45,,,
Ministry of Mines,2016,2,74,40,34,0.540540541,,,
Ministry of Mines,2016,3,90,68,22,0.755555556,,,
Ministry of Mines,2016,4,90,79,11,0.877777778,,,
Ministry of Mines,2016,5,67,66,1,0.985074627,,,
Ministry of Mines,2016,6,85,85,0,1,,,
Ministry of Mines,2016,7,105,67,38,0.638095238,,,
Ministry of Mines,2016,8,86,102,-16,1.186046512,,,
Ministry of Mines,2016,9,102,68,34,0.666666667,,,
Ministry of Mines,2016,10,75,82,-7,1.093333333,,,
Ministry of Mines,2016,11,66,48,18,0.727272727,,,
Ministry of Mines,2016,12,97,44,53,0.453608247,,,
Ministry of Mines,2017,1,103,26,77,0.252427184,,,
Ministry of Mines,2017,2,67,44,23,0.656716418,,,
Ministry of Mines,2017,3,87,100,-13,1.149425287,,,
Ministry of Mines,2017,4,105,49,56,0.466666667,,,
Ministry of Mines,2017,5,92,112,-20,1.217391304,,,
Ministry of Mines,2017,6,123,156,-33,1.268292683,,,
Ministry of Mines,2017,7,109,279,-170,2.559633028,,,
Ministry of Mines,2017,8,92,90,2,0.97826087,,,
Ministry of Mines,2017,9,88,71,17,0.806818182,,,
Ministry of Mines,2017,10,81,85,-4,1.049382716,,,
Ministry of Mines,2017,11,108,94,14,0.87037037,,,
Ministry of Mines,2017,12,110,70,40,0.636363636,,,
Ministry of Mines,2018,1,83,66,17,0.795180723,,,
Ministry of Mines,2018,2,49,75,-26,1.530612245,,,
Ministry of Mines,2018,3,80,73,7,0.9125,,,
Ministry of Mines,2018,4,125,116,9,0.928,,,
Ministry of Mines,2018,5,120,183,-63,1.525,,,
Ministry of Mines,2018,6,73,60,13,0.821917808,,,
Ministry of Mines,2018,7,88,60,28,0.681818182,,,
Ministry of Mines,2018,8,103,78,25,0.757281553,,,
Ministry of Mines,2018,9,70,60,10,0.857142857,,,
Ministry of Mines,2018,10,105,117,-12,1.114285714,,,
Ministry of Mines,2018,11,81,136,-55,1.679012346,,,
Ministry of Mines,2018,12,102,121,-19,1.18627451,,,
Ministry of Mines,2019,1,147,116,31,0.789115646,,,
Ministry of Mines,2019,2,95,70,25,0.736842105,,,
Ministry of Mines,2019,3,81,91,-10,1.12345679,,,
Ministry of Mines,2019,4,79,53,26,0.670886076,,,
Ministry of Mines,2019,5,99,131,-32,1.323232323,,,
Ministry of Mines,2019,6,106,63,43,0.594339623,,,
Ministry of Mines,2019,7,95,81,14,0.852631579,,,
Ministry of Mines,2019,8,119,128,-9,1.075630252,,,
Ministry of Mines,2019,9,125,114,11,0.912,,,
Ministry of Mines,2019,10,89,68,21,0.764044944,,,
Ministry of Minority Affairs,2016,1,79,34,45,0.430379747,,,
Ministry of Minority Affairs,2016,2,86,49,37,0.569767442,,,
Ministry of Minority Affairs,2016,3,142,36,106,0.253521127,,,
Ministry of Minority Affairs,2016,4,124,65,59,0.524193548,,,
Ministry of Minority Affairs,2016,5,138,97,41,0.702898551,,,
Ministry of Minority Affairs,2016,6,122,66,56,0.540983607,,,
Ministry of Minority Affairs,2016,7,103,113,-10,1.097087379,,,
Ministry of Minority Affairs,2016,8,140,92,48,0.657142857,,,
Ministry of Minority Affairs,2016,9,149,49,100,0.32885906,,,
Ministry of Minority Affairs,2016,10,102,116,-14,1.137254902,,,
Ministry of Minority Affairs,2016,11,89,375,-286,4.213483146,,,
Ministry of Minority Affairs,2016,12,76,8,68,0.105263158,,,
Ministry of Minority Affairs,2017,1,85,94,-9,1.105882353,,,
Ministry of Minority Affairs,2017,2,109,131,-22,1.201834862,,,
Ministry of Minority Affairs,2017,3,143,82,61,0.573426573,,,
Ministry of Minority Affairs,2017,4,159,84,75,0.528301887,,,
Ministry of Minority Affairs,2017,5,170,195,-25,1.147058824,,,
Ministry of Minority Affairs,2017,6,259,393,-134,1.517374517,,,
Ministry of Minority Affairs,2017,7,263,272,-9,1.034220532,,,
Ministry of Minority Affairs,2017,8,301,305,-4,1.013289037,,,
Ministry of Minority Affairs,2017,9,202,213,-11,1.054455446,,,
Ministry of Minority Affairs,2017,10,259,241,18,0.930501931,,,
Ministry of Minority Affairs,2017,11,181,139,42,0.767955801,,,
Ministry of Minority Affairs,2017,12,150,139,11,0.926666667,,,
Ministry of Minority Affairs,2018,1,139,105,34,0.755395683,,,
Ministry of Minority Affairs,2018,2,203,149,54,0.733990148,,,
Ministry of Minority Affairs,2018,3,164,118,46,0.719512195,,,
Ministry of Minority Affairs,2018,4,190,173,17,0.910526316,,,
Ministry of Minority Affairs,2018,5,260,380,-120,1.461538462,,,
Ministry of Minority Affairs,2018,6,159,204,-45,1.283018868,,,
Ministry of Minority Affairs,2018,7,153,254,-101,1.660130719,,,
Ministry of Minority Affairs,2018,8,187,141,46,0.754010695,,,
Ministry of Minority Affairs,2018,9,122,129,-7,1.057377049,,,
Ministry of Minority Affairs,2018,10,145,114,31,0.786206897,,,
Ministry of Minority Affairs,2018,11,105,129,-24,1.228571429,,,
Ministry of Minority Affairs,2018,12,105,64,41,0.60952381,,,
Ministry of Minority Affairs,2019,1,209,117,92,0.559808612,,,
Ministry of Minority Affairs,2019,2,257,153,104,0.595330739,,,
Ministry of Minority Affairs,2019,3,227,59,168,0.259911894,,,
Ministry of Minority Affairs,2019,4,137,5,132,0.03649635,,,
Ministry of Minority Affairs,2019,5,96,13,83,0.135416667,,,
Ministry of Minority Affairs,2019,6,150,10,140,0.066666667,,,
Ministry of Minority Affairs,2019,7,159,5,154,0.031446541,,,
Ministry of Minority Affairs,2019,8,123,152,-29,1.235772358,,,
Ministry of Minority Affairs,2019,9,113,171,-58,1.513274336,,,
Ministry of Minority Affairs,2019,10,159,835,-676,5.251572327,,,
Ministry of New and Renewable Energy,2016,1,101,31,70,0.306930693,,,
Ministry of New and Renewable Energy,2016,2,92,70,22,0.760869565,,,
Ministry of New and Renewable Energy,2016,3,111,37,74,0.333333333,,,
Ministry of New and Renewable Energy,2016,4,112,69,43,0.616071429,,,
Ministry of New and Renewable Energy,2016,5,102,85,17,0.833333333,,,
Ministry of New and Renewable Energy,2016,6,135,117,18,0.866666667,,,
Ministry of New and Renewable Energy,2016,7,96,59,37,0.614583333,,,
Ministry of New and Renewable Energy,2016,8,144,35,109,0.243055556,,,
Ministry of New and Renewable Energy,2016,9,99,138,-39,1.393939394,,,
Ministry of New and Renewable Energy,2016,10,81,76,5,0.938271605,,,
Ministry of New and Renewable Energy,2016,11,71,97,-26,1.366197183,,,
Ministry of New and Renewable Energy,2016,12,107,162,-55,1.514018692,,,
Ministry of New and Renewable Energy,2017,1,77,146,-69,1.896103896,,,
Ministry of New and Renewable Energy,2017,2,79,64,15,0.810126582,,,
Ministry of New and Renewable Energy,2017,3,111,53,58,0.477477477,,,
Ministry of New and Renewable Energy,2017,4,67,40,27,0.597014925,,,
Ministry of New and Renewable Energy,2017,5,97,171,-74,1.762886598,,,
Ministry of New and Renewable Energy,2017,6,118,203,-85,1.720338983,,,
Ministry of New and Renewable Energy,2017,7,101,197,-96,1.95049505,,,
Ministry of New and Renewable Energy,2017,8,75,88,-13,1.173333333,,,
Ministry of New and Renewable Energy,2017,9,59,50,9,0.847457627,,,
Ministry of New and Renewable Energy,2017,10,62,57,5,0.919354839,,,
Ministry of New and Renewable Energy,2017,11,64,59,5,0.921875,,,
Ministry of New and Renewable Energy,2017,12,50,80,-30,1.6,,,
Ministry of New and Renewable Energy,2018,1,52,51,1,0.980769231,,,
Ministry of New and Renewable Energy,2018,2,45,47,-2,1.044444444,,,
Ministry of New and Renewable Energy,2018,3,66,47,19,0.712121212,,,
Ministry of New and Renewable Energy,2018,4,76,71,5,0.934210526,,,
Ministry of New and Renewable Energy,2018,5,137,143,-6,1.04379562,,,
Ministry of New and Renewable Energy,2018,6,48,60,-12,1.25,,,
Ministry of New and Renewable Energy,2018,7,81,68,13,0.839506173,,,
Ministry of New and Renewable Energy,2018,8,87,88,-1,1.011494253,,,
Ministry of New and Renewable Energy,2018,9,60,71,-11,1.183333333,,,
Ministry of New and Renewable Energy,2018,10,87,79,8,0.908045977,,,
Ministry of New and Renewable Energy,2018,11,49,49,0,1,,,
Ministry of New and Renewable Energy,2018,12,79,88,-9,1.113924051,,,
Ministry of New and Renewable Energy,2019,1,72,83,-11,1.152777778,,,
Ministry of New and Renewable Energy,2019,2,76,63,13,0.828947368,,,
Ministry of New and Renewable Energy,2019,3,63,55,8,0.873015873,,,
Ministry of New and Renewable Energy,2019,4,48,65,-17,1.354166667,,,
Ministry of New and Renewable Energy,2019,5,42,42,0,1,,,
Ministry of New and Renewable Energy,2019,6,96,85,11,0.885416667,,,
Ministry of New and Renewable Energy,2019,7,81,84,-3,1.037037037,,,
Ministry of New and Renewable Energy,2019,8,75,82,-7,1.093333333,,,
Ministry of New and Renewable Energy,2019,9,85,69,16,0.811764706,,,
Ministry of New and Renewable Energy,2019,10,97,106,-9,1.092783505,,,
Ministry of Panchayati Raj,2016,1,61,38,23,0.62295082,,,
Ministry of Panchayati Raj,2016,2,96,92,4,0.958333333,,,
Ministry of Panchayati Raj,2016,3,84,86,-2,1.023809524,,,
Ministry of Panchayati Raj,2016,4,72,73,-1,1.013888889,,,
Ministry of Panchayati Raj,2016,5,85,83,2,0.976470588,,,
Ministry of Panchayati Raj,2016,6,107,76,31,0.710280374,,,
Ministry of Panchayati Raj,2016,7,69,115,-46,1.666666667,,,
Ministry of Panchayati Raj,2016,8,88,68,20,0.772727273,,,
Ministry of Panchayati Raj,2016,9,101,109,-8,1.079207921,,,
Ministry of Panchayati Raj,2016,10,116,106,10,0.913793103,,,
Ministry of Panchayati Raj,2016,11,93,66,27,0.709677419,,,
Ministry of Panchayati Raj,2016,12,109,128,-19,1.174311927,,,
Ministry of Panchayati Raj,2017,1,96,53,43,0.552083333,,,
Ministry of Panchayati Raj,2017,2,89,151,-62,1.696629213,,,
Ministry of Panchayati Raj,2017,3,120,118,2,0.983333333,,,
Ministry of Panchayati Raj,2017,4,143,118,25,0.825174825,,,
Ministry of Panchayati Raj,2017,5,150,167,-17,1.113333333,,,
Ministry of Panchayati Raj,2017,6,119,115,4,0.966386555,,,
Ministry of Panchayati Raj,2017,7,160,156,4,0.975,,,
Ministry of Panchayati Raj,2017,8,171,184,-13,1.076023392,,,
Ministry of Panchayati Raj,2017,9,155,153,2,0.987096774,,,
Ministry of Panchayati Raj,2017,10,187,177,10,0.946524064,,,
Ministry of Panchayati Raj,2017,11,147,157,-10,1.068027211,,,
Ministry of Panchayati Raj,2017,12,152,153,-1,1.006578947,,,
Ministry of Panchayati Raj,2018,1,74,79,-5,1.067567568,,,
Ministry of Panchayati Raj,2018,2,84,75,9,0.892857143,,,
Ministry of Panchayati Raj,2018,3,96,108,-12,1.125,,,
Ministry of Panchayati Raj,2018,4,105,100,5,0.952380952,,,
Ministry of Panchayati Raj,2018,5,151,157,-6,1.039735099,,,
Ministry of Panchayati Raj,2018,6,97,96,1,0.989690722,,,
Ministry of Panchayati Raj,2018,7,108,116,-8,1.074074074,,,
Ministry of Panchayati Raj,2018,8,122,126,-4,1.032786885,,,
Ministry of Panchayati Raj,2018,9,120,121,-1,1.008333333,,,
Ministry of Panchayati Raj,2018,10,146,144,2,0.98630137,,,
Ministry of Panchayati Raj,2018,11,91,93,-2,1.021978022,,,
Ministry of Panchayati Raj,2018,12,126,118,8,0.936507937,,,
Ministry of Panchayati Raj,2019,1,167,163,4,0.976047904,,,
Ministry of Panchayati Raj,2019,2,158,147,11,0.930379747,,,
Ministry of Panchayati Raj,2019,3,159,161,-2,1.012578616,,,
Ministry of Panchayati Raj,2019,4,85,85,0,1,,,
Ministry of Panchayati Raj,2019,5,118,105,13,0.889830508,,,
Ministry of Panchayati Raj,2019,6,174,178,-4,1.022988506,,,
Ministry of Panchayati Raj,2019,7,230,222,8,0.965217391,,,
Ministry of Panchayati Raj,2019,8,237,229,8,0.966244726,,,
Ministry of Panchayati Raj,2019,9,196,207,-11,1.056122449,,,
Ministry of Panchayati Raj,2019,10,144,123,21,0.854166667,,,
Ministry of Parliamentary Affairs,2016,1,43,3,40,0.069767442,,,
Ministry of Parliamentary Affairs,2016,2,60,93,-33,1.55,,,
Ministry of Parliamentary Affairs,2016,3,80,84,-4,1.05,,,
Ministry of Parliamentary Affairs,2016,4,44,41,3,0.931818182,,,
Ministry of Parliamentary Affairs,2016,5,57,46,11,0.807017544,,,
Ministry of Parliamentary Affairs,2016,6,44,45,-1,1.022727273,,,
Ministry of Parliamentary Affairs,2016,7,67,61,6,0.910447761,,,
Ministry of Parliamentary Affairs,2016,8,95,103,-8,1.084210526,,,
Ministry of Parliamentary Affairs,2016,9,59,65,-6,1.101694915,,,
Ministry of Parliamentary Affairs,2016,10,55,60,-5,1.090909091,,,
Ministry of Parliamentary Affairs,2016,11,64,46,18,0.71875,,,
Ministry of Parliamentary Affairs,2016,12,126,110,16,0.873015873,,,
Ministry of Parliamentary Affairs,2017,1,54,60,-6,1.111111111,,,
Ministry of Parliamentary Affairs,2017,2,56,47,9,0.839285714,,,
Ministry of Parliamentary Affairs,2017,3,81,80,1,0.987654321,,,
Ministry of Parliamentary Affairs,2017,4,73,42,31,0.575342466,,,
Ministry of Parliamentary Affairs,2017,5,66,98,-32,1.484848485,,,
Ministry of Parliamentary Affairs,2017,6,56,50,6,0.892857143,,,
Ministry of Parliamentary Affairs,2017,7,70,83,-13,1.185714286,,,
Ministry of Parliamentary Affairs,2017,8,105,83,22,0.79047619,,,
Ministry of Parliamentary Affairs,2017,9,45,54,-9,1.2,,,
Ministry of Parliamentary Affairs,2017,10,50,48,2,0.96,,,
Ministry of Parliamentary Affairs,2017,11,58,58,0,1,,,
Ministry of Parliamentary Affairs,2017,12,84,82,2,0.976190476,,,
Ministry of Parliamentary Affairs,2018,1,42,49,-7,1.166666667,,,
Ministry of Parliamentary Affairs,2018,2,49,84,-35,1.714285714,,,
Ministry of Parliamentary Affairs,2018,3,66,47,19,0.712121212,,,
Ministry of Parliamentary Affairs,2018,4,115,95,20,0.826086957,,,
Ministry of Parliamentary Affairs,2018,5,111,117,-6,1.054054054,,,
Ministry of Parliamentary Affairs,2018,6,32,6,26,0.1875,,,
Ministry of Parliamentary Affairs,2018,7,56,75,-19,1.339285714,,,
Ministry of Parliamentary Affairs,2018,8,56,70,-14,1.25,,,
Ministry of Parliamentary Affairs,2018,9,48,45,3,0.9375,,,
Ministry of Parliamentary Affairs,2018,10,76,98,-22,1.289473684,,,
Ministry of Parliamentary Affairs,2018,11,77,82,-5,1.064935065,,,
Ministry of Parliamentary Affairs,2018,12,89,90,-1,1.011235955,,,
Ministry of Parliamentary Affairs,2019,1,67,69,-2,1.029850746,,,
Ministry of Parliamentary Affairs,2019,2,71,67,4,0.943661972,,,
Ministry of Parliamentary Affairs,2019,3,77,42,35,0.545454545,,,
Ministry of Parliamentary Affairs,2019,4,46,80,-34,1.739130435,,,
Ministry of Parliamentary Affairs,2019,5,37,41,-4,1.108108108,,,
Ministry of Parliamentary Affairs,2019,6,76,74,2,0.973684211,,,
Ministry of Parliamentary Affairs,2019,7,77,90,-13,1.168831169,,,
Ministry of Parliamentary Affairs,2019,8,66,65,1,0.984848485,,,
Ministry of Parliamentary Affairs,2019,9,68,65,3,0.955882353,,,
Ministry of Parliamentary Affairs,2019,10,45,49,-4,1.088888889,,,
Ministry of Petroleum and Natural Gas,2016,1,1027,225,802,0.219084713,,,
Ministry of Petroleum and Natural Gas,2016,2,1109,987,122,0.889990983,,,
Ministry of Petroleum and Natural Gas,2016,3,889,1391,-502,1.564679415,,,
Ministry of Petroleum and Natural Gas,2016,4,842,717,125,0.851543943,,,
Ministry of Petroleum and Natural Gas,2016,5,933,1067,-134,1.143622722,,,
Ministry of Petroleum and Natural Gas,2016,6,1144,1023,121,0.894230769,,,
Ministry of Petroleum and Natural Gas,2016,7,1124,924,200,0.822064057,,,
Ministry of Petroleum and Natural Gas,2016,8,1242,1331,-89,1.071658615,,,
Ministry of Petroleum and Natural Gas,2016,9,1206,1221,-15,1.012437811,,,
Ministry of Petroleum and Natural Gas,2016,10,1126,860,266,0.763765542,,,
Ministry of Petroleum and Natural Gas,2016,11,1320,1254,66,0.95,,,
Ministry of Petroleum and Natural Gas,2016,12,1806,1509,297,0.835548173,,,
Ministry of Petroleum and Natural Gas,2017,1,1675,1491,184,0.890149254,,,
Ministry of Petroleum and Natural Gas,2017,2,1269,1841,-572,1.450748621,,,
Ministry of Petroleum and Natural Gas,2017,3,1583,1413,170,0.89260897,,,
Ministry of Petroleum and Natural Gas,2017,4,1401,1108,293,0.790863669,,,
Ministry of Petroleum and Natural Gas,2017,5,1528,1907,-379,1.248036649,,,
Ministry of Petroleum and Natural Gas,2017,6,1187,1083,104,0.912384162,,,
Ministry of Petroleum and Natural Gas,2017,7,1193,1413,-220,1.184409053,,,
Ministry of Petroleum and Natural Gas,2017,8,1207,1022,185,0.846727423,,,
Ministry of Petroleum and Natural Gas,2017,9,1296,1618,-322,1.24845679,,,
Ministry of Petroleum and Natural Gas,2017,10,1156,1012,144,0.875432526,,,
Ministry of Petroleum and Natural Gas,2017,11,1276,1404,-128,1.10031348,,,
Ministry of Petroleum and Natural Gas,2017,12,1313,1057,256,0.805026657,,,
Ministry of Petroleum and Natural Gas,2018,1,1058,1403,-345,1.326086957,,,
Ministry of Petroleum and Natural Gas,2018,2,1024,1008,16,0.984375,,,
Ministry of Petroleum and Natural Gas,2018,3,1161,1068,93,0.919896641,,,
Ministry of Petroleum and Natural Gas,2018,4,1175,1004,171,0.854468085,,,
Ministry of Petroleum and Natural Gas,2018,5,1517,1679,-162,1.106789717,,,
Ministry of Petroleum and Natural Gas,2018,6,1133,1174,-41,1.036187114,,,
Ministry of Petroleum and Natural Gas,2018,7,1493,1435,58,0.961152043,,,
Ministry of Petroleum and Natural Gas,2018,8,1517,1546,-29,1.019116678,,,
Ministry of Petroleum and Natural Gas,2018,9,2150,1736,414,0.80744186,,,
Ministry of Petroleum and Natural Gas,2018,10,2231,2285,-54,1.024204393,,,
Ministry of Petroleum and Natural Gas,2018,11,1812,1850,-38,1.020971302,,,
Ministry of Petroleum and Natural Gas,2018,12,1825,2062,-237,1.129863014,,,
Ministry of Petroleum and Natural Gas,2019,1,1837,1769,68,0.962983125,,,
Ministry of Petroleum and Natural Gas,2019,2,2098,1637,461,0.780266921,,,
Ministry of Petroleum and Natural Gas,2019,3,2119,2135,-16,1.007550731,,,
Ministry of Petroleum and Natural Gas,2019,4,1506,2108,-602,1.399734396,,,
Ministry of Petroleum and Natural Gas,2019,5,1479,1578,-99,1.06693712,,,
Ministry of Petroleum and Natural Gas,2019,6,1754,1472,282,0.839224629,,,
Ministry of Petroleum and Natural Gas,2019,7,2052,1833,219,0.893274854,,,
Ministry of Petroleum and Natural Gas,2019,8,2024,1738,286,0.858695652,,,
Ministry of Petroleum and Natural Gas,2019,9,1834,2457,-623,1.339694656,,,
Ministry of Petroleum and Natural Gas,2019,10,1375,1558,-183,1.133090909,,,
Ministry of Petroleum and Natural Gas,2019,11,41,103,-62,2.512195122,,,
Ministry of Power,2016,1,193,51,142,0.264248705,,,
Ministry of Power,2016,2,241,25,216,0.10373444,,,
Ministry of Power,2016,3,308,201,107,0.652597403,,,
Ministry of Power,2016,4,304,330,-26,1.085526316,,,
Ministry of Power,2016,5,352,411,-59,1.167613636,,,
Ministry of Power,2016,6,387,288,99,0.744186047,,,
Ministry of Power,2016,7,307,304,3,0.990228013,,,
Ministry of Power,2016,8,358,483,-125,1.349162011,,,
Ministry of Power,2016,9,318,391,-73,1.229559748,,,
Ministry of Power,2016,10,244,261,-17,1.069672131,,,
Ministry of Power,2016,11,216,214,2,0.990740741,,,
Ministry of Power,2016,12,285,128,157,0.449122807,,,
Ministry of Power,2017,1,236,122,114,0.516949153,,,
Ministry of Power,2017,2,282,488,-206,1.730496454,,,
Ministry of Power,2017,3,360,307,53,0.852777778,,,
Ministry of Power,2017,4,370,427,-57,1.154054054,,,
Ministry of Power,2017,5,401,364,37,0.907730673,,,
Ministry of Power,2017,6,445,469,-24,1.053932584,,,
Ministry of Power,2017,7,433,498,-65,1.150115473,,,
Ministry of Power,2017,8,447,418,29,0.935123043,,,
Ministry of Power,2017,9,349,383,-34,1.097421203,,,
Ministry of Power,2017,10,372,328,44,0.88172043,,,
Ministry of Power,2017,11,374,406,-32,1.085561497,,,
Ministry of Power,2017,12,391,333,58,0.851662404,,,
Ministry of Power,2018,1,271,339,-68,1.250922509,,,
Ministry of Power,2018,2,202,202,0,1,,,
Ministry of Power,2018,3,284,306,-22,1.077464789,,,
Ministry of Power,2018,4,420,293,127,0.697619048,,,
Ministry of Power,2018,5,476,372,104,0.781512605,,,
Ministry of Power,2018,6,355,289,66,0.814084507,,,
Ministry of Power,2018,7,465,607,-142,1.305376344,,,
Ministry of Power,2018,8,422,396,26,0.938388626,,,
Ministry of Power,2018,9,351,387,-36,1.102564103,,,
Ministry of Power,2018,10,355,380,-25,1.070422535,,,
Ministry of Power,2018,11,329,361,-32,1.097264438,,,
Ministry of Power,2018,12,321,353,-32,1.099688474,,,
Ministry of Power,2019,1,356,374,-18,1.050561798,,,
Ministry of Power,2019,2,278,305,-27,1.097122302,,,
Ministry of Power,2019,3,251,257,-6,1.023904382,,,
Ministry of Power,2019,4,230,281,-51,1.22173913,,,
Ministry of Power,2019,5,269,297,-28,1.104089219,,,
Ministry of Power,2019,6,471,364,107,0.772823779,,,
Ministry of Power,2019,7,464,453,11,0.976293103,,,
Ministry of Power,2019,8,355,388,-33,1.092957746,,,
Ministry of Power,2019,9,332,306,26,0.921686747,,,
Ministry of Power,2019,10,318,291,27,0.91509434,,,
Ministry of Power,2019,11,4,14,-10,3.5,,,
Ministry of Railways ( Railway Board),2016,1,3898,1268,2630,0.325295023,,,
Ministry of Railways ( Railway Board),2016,2,4306,2973,1333,0.690431955,,,
Ministry of Railways ( Railway Board),2016,3,8101,3986,4115,0.49203802,,,
Ministry of Railways ( Railway Board),2016,4,4283,3946,337,0.921316834,,,
Ministry of Railways ( Railway Board),2016,5,4504,7385,-2881,1.639653641,,,
Ministry of Railways ( Railway Board),2016,6,4731,3114,1617,0.658211795,,,
Ministry of Railways ( Railway Board),2016,7,4413,3873,540,0.877634262,,,
Ministry of Railways ( Railway Board),2016,8,4866,4718,148,0.969584875,,,
Ministry of Railways ( Railway Board),2016,9,4679,4759,-80,1.01709767,,,
Ministry of Railways ( Railway Board),2016,10,4020,2722,1298,0.677114428,,,
Ministry of Railways ( Railway Board),2016,11,3849,2675,1174,0.694985711,,,
Ministry of Railways ( Railway Board),2016,12,5170,3553,1617,0.687234043,,,
Ministry of Railways ( Railway Board),2017,1,4270,4701,-431,1.100936768,,,
Ministry of Railways ( Railway Board),2017,2,4161,7448,-3287,1.789954338,,,
Ministry of Railways ( Railway Board),2017,3,4744,6413,-1669,1.351812816,,,
Ministry of Railways ( Railway Board),2017,4,5488,5224,264,0.951895044,,,
Ministry of Railways ( Railway Board),2017,5,5730,5776,-46,1.008027923,,,
Ministry of Railways ( Railway Board),2017,6,4674,5269,-595,1.127299957,,,
Ministry of Railways ( Railway Board),2017,7,4495,4494,1,0.999777531,,,
Ministry of Railways ( Railway Board),2017,8,4812,4664,148,0.969243558,,,
Ministry of Railways ( Railway Board),2017,9,4793,4710,83,0.982683079,,,
Ministry of Railways ( Railway Board),2017,10,5102,4973,129,0.974715798,,,
Ministry of Railways ( Railway Board),2017,11,4786,5147,-361,1.075428333,,,
Ministry of Railways ( Railway Board),2017,12,4793,4936,-143,1.029835176,,,
Ministry of Railways ( Railway Board),2018,1,3784,4615,-831,1.219608879,,,
Ministry of Railways ( Railway Board),2018,2,3817,4330,-513,1.134398742,,,
Ministry of Railways ( Railway Board),2018,3,4004,4028,-24,1.005994006,,,
Ministry of Railways ( Railway Board),2018,4,4322,4518,-196,1.045349375,,,
Ministry of Railways ( Railway Board),2018,5,5288,5328,-40,1.007564297,,,
Ministry of Railways ( Railway Board),2018,6,4406,4254,152,0.965501589,,,
Ministry of Railways ( Railway Board),2018,7,4744,5418,-674,1.142074199,,,
Ministry of Railways ( Railway Board),2018,8,4542,4803,-261,1.057463672,,,
Ministry of Railways ( Railway Board),2018,9,3979,4158,-179,1.044986177,,,
Ministry of Railways ( Railway Board),2018,10,4557,4691,-134,1.029405311,,,
Ministry of Railways ( Railway Board),2018,11,3767,3478,289,0.923281126,,,
Ministry of Railways ( Railway Board),2018,12,3723,3684,39,0.989524577,,,
Ministry of Railways ( Railway Board),2019,1,4673,4566,107,0.977102504,,,
Ministry of Railways ( Railway Board),2019,2,4552,4059,493,0.891695958,,,
Ministry of Railways ( Railway Board),2019,3,4854,4419,435,0.910383189,,,
Ministry of Railways ( Railway Board),2019,4,4288,4423,-135,1.031483209,,,
Ministry of Railways ( Railway Board),2019,5,3764,4810,-1046,1.277895855,,,
Ministry of Railways ( Railway Board),2019,6,5305,4202,1103,0.792082941,,,
Ministry of Railways ( Railway Board),2019,7,5896,5593,303,0.948609227,,,
Ministry of Railways ( Railway Board),2019,8,4661,4557,104,0.977687192,,,
Ministry of Railways ( Railway Board),2019,9,5012,5192,-180,1.035913807,,,
Ministry of Railways ( Railway Board),2019,10,4506,4431,75,0.983355526,,,
Ministry of Railways ( Railway Board),2019,11,164,192,-28,1.170731707,,,
Ministry of Road Transport and Highways,2016,1,622,80,542,0.128617363,,,
Ministry of Road Transport and Highways,2016,2,716,712,4,0.994413408,,,
Ministry of Road Transport and Highways,2016,3,682,683,-1,1.001466276,,,
Ministry of Road Transport and Highways,2016,4,661,524,137,0.792738275,,,
Ministry of Road Transport and Highways,2016,5,682,689,-7,1.01026393,,,
Ministry of Road Transport and Highways,2016,6,952,579,373,0.608193277,,,
Ministry of Road Transport and Highways,2016,7,1528,1297,231,0.84882199,,,
Ministry of Road Transport and Highways,2016,8,1190,1115,75,0.93697479,,,
Ministry of Road Transport and Highways,2016,9,874,953,-79,1.090389016,,,
Ministry of Road Transport and Highways,2016,10,745,811,-66,1.088590604,,,
Ministry of Road Transport and Highways,2016,11,925,697,228,0.753513514,,,
Ministry of Road Transport and Highways,2016,12,1199,1201,-2,1.001668057,,,
Ministry of Road Transport and Highways,2017,1,797,856,-59,1.074027604,,,
Ministry of Road Transport and Highways,2017,2,683,701,-18,1.026354319,,,
Ministry of Road Transport and Highways,2017,3,937,1065,-128,1.13660619,,,
Ministry of Road Transport and Highways,2017,4,872,709,163,0.813073394,,,
Ministry of Road Transport and Highways,2017,5,903,1093,-190,1.210409745,,,
Ministry of Road Transport and Highways,2017,6,720,763,-43,1.059722222,,,
Ministry of Road Transport and Highways,2017,7,769,456,313,0.592977893,,,
Ministry of Road Transport and Highways,2017,8,936,733,203,0.783119658,,,
Ministry of Road Transport and Highways,2017,9,830,510,320,0.614457831,,,
Ministry of Road Transport and Highways,2017,10,808,645,163,0.798267327,,,
Ministry of Road Transport and Highways,2017,11,842,752,90,0.893111639,,,
Ministry of Road Transport and Highways,2017,12,862,1099,-237,1.274941995,,,
Ministry of Road Transport and Highways,2018,1,700,1112,-412,1.588571429,,,
Ministry of Road Transport and Highways,2018,2,645,516,129,0.8,,,
Ministry of Road Transport and Highways,2018,3,829,702,127,0.846803378,,,
Ministry of Road Transport and Highways,2018,4,777,624,153,0.803088803,,,
Ministry of Road Transport and Highways,2018,5,964,984,-20,1.020746888,,,
Ministry of Road Transport and Highways,2018,6,789,778,11,0.986058302,,,
Ministry of Road Transport and Highways,2018,7,1120,739,381,0.659821429,,,
Ministry of Road Transport and Highways,2018,8,1116,1388,-272,1.243727599,,,
Ministry of Road Transport and Highways,2018,9,956,1176,-220,1.230125523,,,
Ministry of Road Transport and Highways,2018,10,859,1478,-619,1.720605355,,,
Ministry of Road Transport and Highways,2018,11,784,725,59,0.924744898,,,
Ministry of Road Transport and Highways,2018,12,884,790,94,0.893665158,,,
Ministry of Road Transport and Highways,2019,1,959,784,175,0.817518248,,,
Ministry of Road Transport and Highways,2019,2,803,987,-184,1.229140722,,,
Ministry of Road Transport and Highways,2019,3,741,858,-117,1.157894737,,,
Ministry of Road Transport and Highways,2019,4,734,1018,-284,1.386920981,,,
Ministry of Road Transport and Highways,2019,5,768,873,-105,1.13671875,,,
Ministry of Road Transport and Highways,2019,6,1357,908,449,0.669123066,,,
Ministry of Road Transport and Highways,2019,7,1347,1297,50,0.962880475,,,
Ministry of Road Transport and Highways,2019,8,1093,1087,6,0.994510522,,,
Ministry of Road Transport and Highways,2019,9,2011,1412,599,0.70213824,,,
Ministry of Road Transport and Highways,2019,10,1462,1396,66,0.954856361,,,
Ministry of Road Transport and Highways,2019,11,44,3,41,0.068181818,,,
Ministry of Shipping,2016,1,83,27,56,0.325301205,,,
Ministry of Shipping,2016,2,104,88,16,0.846153846,,,
Ministry of Shipping,2016,3,118,99,19,0.838983051,,,
Ministry of Shipping,2016,4,155,115,40,0.741935484,,,
Ministry of Shipping,2016,5,127,191,-64,1.503937008,,,
Ministry of Shipping,2016,6,139,112,27,0.805755396,,,
Ministry of Shipping,2016,7,125,147,-22,1.176,,,
Ministry of Shipping,2016,8,177,168,9,0.949152542,,,
Ministry of Shipping,2016,9,188,130,58,0.691489362,,,
Ministry of Shipping,2016,10,124,162,-38,1.306451613,,,
Ministry of Shipping,2016,11,143,128,15,0.895104895,,,
Ministry of Shipping,2016,12,132,167,-35,1.265151515,,,
Ministry of Shipping,2017,1,114,100,14,0.877192982,,,
Ministry of Shipping,2017,2,118,71,47,0.601694915,,,
Ministry of Shipping,2017,3,171,151,20,0.883040936,,,
Ministry of Shipping,2017,4,187,184,3,0.983957219,,,
Ministry of Shipping,2017,5,183,117,66,0.639344262,,,
Ministry of Shipping,2017,6,161,187,-26,1.161490683,,,
Ministry of Shipping,2017,7,144,128,16,0.888888889,,,
Ministry of Shipping,2017,8,150,136,14,0.906666667,,,
Ministry of Shipping,2017,9,190,170,20,0.894736842,,,
Ministry of Shipping,2017,10,138,233,-95,1.688405797,,,
Ministry of Shipping,2017,11,171,138,33,0.807017544,,,
Ministry of Shipping,2017,12,173,127,46,0.734104046,,,
Ministry of Shipping,2018,1,108,168,-60,1.555555556,,,
Ministry of Shipping,2018,2,124,126,-2,1.016129032,,,
Ministry of Shipping,2018,3,113,128,-15,1.132743363,,,
Ministry of Shipping,2018,4,127,115,12,0.905511811,,,
Ministry of Shipping,2018,5,315,318,-3,1.00952381,,,
Ministry of Shipping,2018,6,129,143,-14,1.108527132,,,
Ministry of Shipping,2018,7,223,234,-11,1.049327354,,,
Ministry of Shipping,2018,8,202,162,40,0.801980198,,,
Ministry of Shipping,2018,9,169,143,26,0.846153846,,,
Ministry of Shipping,2018,10,136,214,-78,1.573529412,,,
Ministry of Shipping,2018,11,134,137,-3,1.02238806,,,
Ministry of Shipping,2018,12,100,46,54,0.46,,,
Ministry of Shipping,2019,1,127,105,22,0.826771654,,,
Ministry of Shipping,2019,2,111,109,2,0.981981982,,,
Ministry of Shipping,2019,3,129,50,79,0.387596899,,,
Ministry of Shipping,2019,4,110,94,16,0.854545455,,,
Ministry of Shipping,2019,5,82,71,11,0.865853659,,,
Ministry of Shipping,2019,6,119,91,28,0.764705882,,,
Ministry of Shipping,2019,7,133,170,-37,1.278195489,,,
Ministry of Shipping,2019,8,92,68,24,0.739130435,,,
Ministry of Shipping,2019,9,122,153,-31,1.254098361,,,
Ministry of Shipping,2019,10,125,68,57,0.544,,,
Ministry of Shipping,2019,11,3,5,-2,1.666666667,,,
Ministry of Skill Development and Entrepreneurship,2016,1,154,49,105,0.318181818,,,
Ministry of Skill Development and Entrepreneurship,2016,2,178,226,-48,1.269662921,,,
Ministry of Skill Development and Entrepreneurship,2016,3,184,158,26,0.858695652,,,
Ministry of Skill Development and Entrepreneurship,2016,4,175,162,13,0.925714286,,,
Ministry of Skill Development and Entrepreneurship,2016,5,175,203,-28,1.16,,,
Ministry of Skill Development and Entrepreneurship,2016,6,252,196,56,0.777777778,,,
Ministry of Skill Development and Entrepreneurship,2016,7,193,152,41,0.787564767,,,
Ministry of Skill Development and Entrepreneurship,2016,8,187,191,-4,1.021390374,,,
Ministry of Skill Development and Entrepreneurship,2016,9,252,150,102,0.595238095,,,
Ministry of Skill Development and Entrepreneurship,2016,10,201,340,-139,1.691542289,,,
Ministry of Skill Development and Entrepreneurship,2016,11,161,126,35,0.782608696,,,
Ministry of Skill Development and Entrepreneurship,2016,12,156,106,50,0.679487179,,,
Ministry of Skill Development and Entrepreneurship,2017,1,122,151,-29,1.237704918,,,
Ministry of Skill Development and Entrepreneurship,2017,2,118,92,26,0.779661017,,,
Ministry of Skill Development and Entrepreneurship,2017,3,182,120,62,0.659340659,,,
Ministry of Skill Development and Entrepreneurship,2017,4,110,135,-25,1.227272727,,,
Ministry of Skill Development and Entrepreneurship,2017,5,253,259,-6,1.023715415,,,
Ministry of Skill Development and Entrepreneurship,2017,6,450,175,275,0.388888889,,,
Ministry of Skill Development and Entrepreneurship,2017,7,302,444,-142,1.470198675,,,
Ministry of Skill Development and Entrepreneurship,2017,8,259,418,-159,1.613899614,,,
Ministry of Skill Development and Entrepreneurship,2017,9,362,236,126,0.651933702,,,
Ministry of Skill Development and Entrepreneurship,2017,10,248,295,-47,1.189516129,,,
Ministry of Skill Development and Entrepreneurship,2017,11,269,259,10,0.962825279,,,
Ministry of Skill Development and Entrepreneurship,2017,12,226,284,-58,1.256637168,,,
Ministry of Skill Development and Entrepreneurship,2018,1,180,279,-99,1.55,,,
Ministry of Skill Development and Entrepreneurship,2018,2,164,200,-36,1.219512195,,,
Ministry of Skill Development and Entrepreneurship,2018,3,179,148,31,0.826815642,,,
Ministry of Skill Development and Entrepreneurship,2018,4,187,223,-36,1.192513369,,,
Ministry of Skill Development and Entrepreneurship,2018,5,297,287,10,0.966329966,,,
Ministry of Skill Development and Entrepreneurship,2018,6,187,184,3,0.983957219,,,
Ministry of Skill Development and Entrepreneurship,2018,7,243,203,40,0.835390947,,,
Ministry of Skill Development and Entrepreneurship,2018,8,212,181,31,0.853773585,,,
Ministry of Skill Development and Entrepreneurship,2018,9,206,196,10,0.951456311,,,
Ministry of Skill Development and Entrepreneurship,2018,10,183,267,-84,1.459016393,,,
Ministry of Skill Development and Entrepreneurship,2018,11,133,130,3,0.977443609,,,
Ministry of Skill Development and Entrepreneurship,2018,12,253,219,34,0.865612648,,,
Ministry of Skill Development and Entrepreneurship,2019,1,209,250,-41,1.196172249,,,
Ministry of Skill Development and Entrepreneurship,2019,2,167,136,31,0.814371257,,,
Ministry of Skill Development and Entrepreneurship,2019,3,168,173,-5,1.029761905,,,
Ministry of Skill Development and Entrepreneurship,2019,4,153,140,13,0.91503268,,,
Ministry of Skill Development and Entrepreneurship,2019,5,119,127,-8,1.067226891,,,
Ministry of Skill Development and Entrepreneurship,2019,6,172,140,32,0.813953488,,,
Ministry of Skill Development and Entrepreneurship,2019,7,272,200,72,0.735294118,,,
Ministry of Skill Development and Entrepreneurship,2019,8,205,204,1,0.995121951,,,
Ministry of Skill Development and Entrepreneurship,2019,9,220,205,15,0.931818182,,,
Ministry of Skill Development and Entrepreneurship,2019,10,187,242,-55,1.294117647,,,
Ministry of Skill Development and Entrepreneurship,2019,11,3,2,1,0.666666667,,,
Ministry of Statistics and Programme Implementation,2016,1,18,8,10,0.444444444,,,15304
Ministry of Statistics and Programme Implementation,2016,2,37,21,16,0.567567568,,,
Ministry of Statistics and Programme Implementation,2016,3,26,16,10,0.615384615,,,
Ministry of Statistics and Programme Implementation,2016,4,18,27,-9,1.5,,,
Ministry of Statistics and Programme Implementation,2016,5,35,31,4,0.885714286,,,
Ministry of Statistics and Programme Implementation,2016,6,38,55,-17,1.447368421,,,
Ministry of Statistics and Programme Implementation,2016,7,23,14,9,0.608695652,,,
Ministry of Statistics and Programme Implementation,2016,8,31,39,-8,1.258064516,,,
Ministry of Statistics and Programme Implementation,2016,9,36,28,8,0.777777778,,,
Ministry of Statistics and Programme Implementation,2016,10,41,15,26,0.365853659,,,
Ministry of Statistics and Programme Implementation,2016,11,49,54,-5,1.102040816,,,
Ministry of Statistics and Programme Implementation,2016,12,36,40,-4,1.111111111,,,
Ministry of Statistics and Programme Implementation,2017,1,32,41,-9,1.28125,,,
Ministry of Statistics and Programme Implementation,2017,2,113,103,10,0.911504425,,,
Ministry of Statistics and Programme Implementation,2017,3,44,35,9,0.795454545,,,
Ministry of Statistics and Programme Implementation,2017,4,26,33,-7,1.269230769,,,
Ministry of Statistics and Programme Implementation,2017,5,34,39,-5,1.147058824,,,
Ministry of Statistics and Programme Implementation,2017,6,24,33,-9,1.375,,,
Ministry of Statistics and Programme Implementation,2017,7,50,41,9,0.82,,,
Ministry of Statistics and Programme Implementation,2017,8,42,46,-4,1.095238095,,,
Ministry of Statistics and Programme Implementation,2017,9,34,26,8,0.764705882,,,
Ministry of Statistics and Programme Implementation,2017,10,31,36,-5,1.161290323,,,
Ministry of Statistics and Programme Implementation,2017,11,50,44,6,0.88,,,
Ministry of Statistics and Programme Implementation,2017,12,37,43,-6,1.162162162,,,
Ministry of Statistics and Programme Implementation,2018,1,34,24,10,0.705882353,,,
Ministry of Statistics and Programme Implementation,2018,2,51,40,11,0.784313725,,,
Ministry of Statistics and Programme Implementation,2018,3,47,63,-16,1.340425532,,,
Ministry of Statistics and Programme Implementation,2018,4,69,62,7,0.898550725,,,
Ministry of Statistics and Programme Implementation,2018,5,76,91,-15,1.197368421,,,
Ministry of Statistics and Programme Implementation,2018,6,31,41,-10,1.322580645,,,
Ministry of Statistics and Programme Implementation,2018,7,29,24,5,0.827586207,,,
Ministry of Statistics and Programme Implementation,2018,8,24,27,-3,1.125,,,
Ministry of Statistics and Programme Implementation,2018,9,22,37,-15,1.681818182,,,
Ministry of Statistics and Programme Implementation,2018,10,30,19,11,0.633333333,,,
Ministry of Statistics and Programme Implementation,2018,11,33,34,-1,1.03030303,,,
Ministry of Statistics and Programme Implementation,2018,12,57,52,5,0.912280702,,,
Ministry of Statistics and Programme Implementation,2019,1,59,57,2,0.966101695,,,
Ministry of Statistics and Programme Implementation,2019,2,43,61,-18,1.418604651,,,
Ministry of Statistics and Programme Implementation,2019,3,60,44,16,0.733333333,,,
Ministry of Statistics and Programme Implementation,2019,4,28,14,14,0.5,,,
Ministry of Statistics and Programme Implementation,2019,5,77,57,20,0.74025974,,,
Ministry of Statistics and Programme Implementation,2019,6,49,61,-12,1.244897959,,,
Ministry of Statistics and Programme Implementation,2019,7,42,63,-21,1.5,,,
Ministry of Statistics and Programme Implementation,2019,8,24,20,4,0.833333333,,,
Ministry of Statistics and Programme Implementation,2019,9,45,55,-10,1.222222222,,,
Ministry of Statistics and Programme Implementation,2019,10,26,17,9,0.653846154,,,
Ministry of Steel,2016,1,89,37,52,0.415730337,,,56856
Ministry of Steel,2016,2,154,109,45,0.707792208,,,
Ministry of Steel,2016,3,129,116,13,0.899224806,,,
Ministry of Steel,2016,4,88,122,-34,1.386363636,,,
Ministry of Steel,2016,5,118,139,-21,1.177966102,,,
Ministry of Steel,2016,6,236,109,127,0.461864407,,,
Ministry of Steel,2016,7,267,274,-7,1.026217228,,,
Ministry of Steel,2016,8,190,219,-29,1.152631579,,,
Ministry of Steel,2016,9,142,180,-38,1.267605634,,,
Ministry of Steel,2016,10,213,114,99,0.535211268,,,
Ministry of Steel,2016,11,188,282,-94,1.5,,,
Ministry of Steel,2016,12,171,165,6,0.964912281,,,
Ministry of Steel,2017,1,124,163,-39,1.314516129,,,
Ministry of Steel,2017,2,90,93,-3,1.033333333,,,
Ministry of Steel,2017,3,118,115,3,0.974576271,,,
Ministry of Steel,2017,4,125,111,14,0.888,,,
Ministry of Steel,2017,5,172,165,7,0.959302326,,,
Ministry of Steel,2017,6,134,139,-5,1.037313433,,,
Ministry of Steel,2017,7,147,166,-19,1.129251701,,,
Ministry of Steel,2017,8,180,148,32,0.822222222,,,
Ministry of Steel,2017,9,113,141,-28,1.247787611,,,
Ministry of Steel,2017,10,86,83,3,0.965116279,,,
Ministry of Steel,2017,11,95,111,-16,1.168421053,,,
Ministry of Steel,2017,12,182,142,40,0.78021978,,,
Ministry of Steel,2018,1,95,129,-34,1.357894737,,,
Ministry of Steel,2018,2,90,104,-14,1.155555556,,,
Ministry of Steel,2018,3,90,82,8,0.911111111,,,
Ministry of Steel,2018,4,96,86,10,0.895833333,,,
Ministry of Steel,2018,5,157,181,-24,1.152866242,,,
Ministry of Steel,2018,6,83,102,-19,1.228915663,,,
Ministry of Steel,2018,7,108,85,23,0.787037037,,,
Ministry of Steel,2018,8,85,85,0,1,,,
Ministry of Steel,2018,9,259,88,171,0.33976834,,,
Ministry of Steel,2018,10,185,362,-177,1.956756757,,,
Ministry of Steel,2018,11,94,95,-1,1.010638298,,,
Ministry of Steel,2018,12,104,106,-2,1.019230769,,,
Ministry of Steel,2019,1,96,108,-12,1.125,,,
Ministry of Steel,2019,2,122,64,58,0.524590164,,,
Ministry of Steel,2019,3,110,167,-57,1.518181818,,,
Ministry of Steel,2019,4,69,72,-3,1.043478261,,,
Ministry of Steel,2019,5,46,56,-10,1.217391304,,,
Ministry of Steel,2019,6,110,79,31,0.718181818,,,
Ministry of Steel,2019,7,133,144,-11,1.082706767,,,
Ministry of Steel,2019,8,129,131,-2,1.015503876,,,
Ministry of Steel,2019,9,132,131,1,0.992424242,,,
Ministry of Steel,2019,10,99,98,1,0.98989899,,,
Ministry of Steel,2019,11,1,5,-4,5,,,
Ministry of Textiles,2016,1,103,52,51,0.504854369,,,0.26917124
Ministry of Textiles,2016,2,111,91,20,0.81981982,,,
Ministry of Textiles,2016,3,114,88,26,0.771929825,,,
Ministry of Textiles,2016,4,98,123,-25,1.255102041,,,
Ministry of Textiles,2016,5,95,94,1,0.989473684,,,
Ministry of Textiles,2016,6,117,94,23,0.803418803,,,
Ministry of Textiles,2016,7,134,164,-30,1.223880597,,,
Ministry of Textiles,2016,8,151,114,37,0.754966887,,,
Ministry of Textiles,2016,9,138,98,40,0.710144928,,,
Ministry of Textiles,2016,10,111,138,-27,1.243243243,,,
Ministry of Textiles,2016,11,98,112,-14,1.142857143,,,
Ministry of Textiles,2016,12,143,94,49,0.657342657,,,
Ministry of Textiles,2017,1,100,108,-8,1.08,,,
Ministry of Textiles,2017,2,118,162,-44,1.372881356,,,
Ministry of Textiles,2017,3,176,131,45,0.744318182,,,
Ministry of Textiles,2017,4,117,115,2,0.982905983,,,
Ministry of Textiles,2017,5,124,151,-27,1.217741935,,,
Ministry of Textiles,2017,6,133,119,14,0.894736842,,,
Ministry of Textiles,2017,7,128,139,-11,1.0859375,,,
Ministry of Textiles,2017,8,156,159,-3,1.019230769,,,
Ministry of Textiles,2017,9,119,55,64,0.462184874,,,
Ministry of Textiles,2017,10,101,216,-115,2.138613861,,,
Ministry of Textiles,2017,11,159,116,43,0.729559748,,,
Ministry of Textiles,2017,12,128,149,-21,1.1640625,,,
Ministry of Textiles,2018,1,126,167,-41,1.325396825,,,
Ministry of Textiles,2018,2,80,80,0,1,,,
Ministry of Textiles,2018,3,95,71,24,0.747368421,,,
Ministry of Textiles,2018,4,99,116,-17,1.171717172,,,
Ministry of Textiles,2018,5,170,179,-9,1.052941176,,,
Ministry of Textiles,2018,6,147,145,2,0.986394558,,,
Ministry of Textiles,2018,7,187,116,71,0.620320856,,,
Ministry of Textiles,2018,8,149,184,-35,1.234899329,,,
Ministry of Textiles,2018,9,128,146,-18,1.140625,,,
Ministry of Textiles,2018,10,125,105,20,0.84,,,
Ministry of Textiles,2018,11,106,104,2,0.981132075,,,
Ministry of Textiles,2018,12,112,114,-2,1.017857143,,,
Ministry of Textiles,2019,1,94,112,-18,1.191489362,,,
Ministry of Textiles,2019,2,90,83,7,0.922222222,,,
Ministry of Textiles,2019,3,173,85,88,0.49132948,,,
Ministry of Textiles,2019,4,70,147,-77,2.1,,,
Ministry of Textiles,2019,5,83,97,-14,1.168674699,,,
Ministry of Textiles,2019,6,93,78,15,0.838709677,,,
Ministry of Textiles,2019,7,147,138,9,0.93877551,,,
Ministry of Textiles,2019,8,111,87,24,0.783783784,,,
Ministry of Textiles,2019,9,113,110,3,0.973451327,,,
Ministry of Textiles,2019,10,119,101,18,0.848739496,,,
Ministry of Tourism,2016,1,165,3,162,0.018181818,,,
Ministry of Tourism,2016,2,87,50,37,0.574712644,,,
Ministry of Tourism,2016,3,84,66,18,0.785714286,,,
Ministry of Tourism,2016,4,102,106,-4,1.039215686,,,
Ministry of Tourism,2016,5,96,122,-26,1.270833333,,,
Ministry of Tourism,2016,6,130,10,120,0.076923077,,,
Ministry of Tourism,2016,7,92,75,17,0.815217391,,,
Ministry of Tourism,2016,8,146,78,68,0.534246575,,,
Ministry of Tourism,2016,9,130,111,19,0.853846154,,,
Ministry of Tourism,2016,10,98,122,-24,1.244897959,,,
Ministry of Tourism,2016,11,83,73,10,0.879518072,,,
Ministry of Tourism,2016,12,125,128,-3,1.024,,,
Ministry of Tourism,2017,1,99,267,-168,2.696969697,,,
Ministry of Tourism,2017,2,105,194,-89,1.847619048,,,
Ministry of Tourism,2017,3,102,73,29,0.715686275,,,
Ministry of Tourism,2017,4,105,94,11,0.895238095,,,
Ministry of Tourism,2017,5,118,117,1,0.991525424,,,
Ministry of Tourism,2017,6,122,146,-24,1.196721311,,,
Ministry of Tourism,2017,7,80,217,-137,2.7125,,,
Ministry of Tourism,2017,8,94,4,90,0.042553191,,,
Ministry of Tourism,2017,9,91,125,-34,1.373626374,,,
Ministry of Tourism,2017,10,112,87,25,0.776785714,,,
Ministry of Tourism,2017,11,90,94,-4,1.044444444,,,
Ministry of Tourism,2017,12,84,49,35,0.583333333,,,
Ministry of Tourism,2018,1,66,145,-79,2.196969697,,,
Ministry of Tourism,2018,2,46,96,-50,2.086956522,,,
Ministry of Tourism,2018,3,63,46,17,0.73015873,,,
Ministry of Tourism,2018,4,82,70,12,0.853658537,,,
Ministry of Tourism,2018,5,154,128,26,0.831168831,,,
Ministry of Tourism,2018,6,81,106,-25,1.308641975,,,
Ministry of Tourism,2018,7,91,98,-7,1.076923077,,,
Ministry of Tourism,2018,8,79,77,2,0.974683544,,,
Ministry of Tourism,2018,9,76,33,43,0.434210526,,,
Ministry of Tourism,2018,10,116,119,-3,1.025862069,,,
Ministry of Tourism,2018,11,81,82,-1,1.012345679,,,
Ministry of Tourism,2018,12,92,144,-52,1.565217391,,,
Ministry of Tourism,2019,1,115,100,15,0.869565217,,,
Ministry of Tourism,2019,2,80,88,-8,1.1,,,
Ministry of Tourism,2019,3,92,87,5,0.945652174,,,
Ministry of Tourism,2019,4,85,89,-4,1.047058824,,,
Ministry of Tourism,2019,5,88,92,-4,1.045454545,,,
Ministry of Tourism,2019,6,167,156,11,0.934131737,,,
Ministry of Tourism,2019,7,116,119,-3,1.025862069,,,
Ministry of Tourism,2019,8,104,99,5,0.951923077,,,
Ministry of Tourism,2019,9,156,148,8,0.948717949,,,
Ministry of Tourism,2019,10,131,147,-16,1.122137405,,,
Ministry of Tourism,2019,11,4,4,0,1,,,
Ministry of Tribal Affairs,2016,1,47,14,33,0.29787234,,,
Ministry of Tribal Affairs,2016,2,68,34,34,0.5,,,
Ministry of Tribal Affairs,2016,3,79,75,4,0.949367089,,,
Ministry of Tribal Affairs,2016,4,72,79,-7,1.097222222,,,
Ministry of Tribal Affairs,2016,5,53,71,-18,1.339622642,,,
Ministry of Tribal Affairs,2016,6,62,19,43,0.306451613,,,
Ministry of Tribal Affairs,2016,7,49,21,28,0.428571429,,,
Ministry of Tribal Affairs,2016,8,95,145,-50,1.526315789,,,
Ministry of Tribal Affairs,2016,9,79,60,19,0.759493671,,,
Ministry of Tribal Affairs,2016,10,85,63,22,0.741176471,,,
Ministry of Tribal Affairs,2016,11,52,66,-14,1.269230769,,,
Ministry of Tribal Affairs,2016,12,100,121,-21,1.21,,,
Ministry of Tribal Affairs,2017,1,99,139,-40,1.404040404,,,
Ministry of Tribal Affairs,2017,2,50,39,11,0.78,,,
Ministry of Tribal Affairs,2017,3,118,99,19,0.838983051,,,
Ministry of Tribal Affairs,2017,4,75,78,-3,1.04,,,
Ministry of Tribal Affairs,2017,5,95,61,34,0.642105263,,,
Ministry of Tribal Affairs,2017,6,76,105,-29,1.381578947,,,
Ministry of Tribal Affairs,2017,7,100,99,1,0.99,,,
Ministry of Tribal Affairs,2017,8,96,24,72,0.25,,,
Ministry of Tribal Affairs,2017,9,63,45,18,0.714285714,,,
Ministry of Tribal Affairs,2017,10,62,20,42,0.322580645,,,
Ministry of Tribal Affairs,2017,11,101,24,77,0.237623762,,,
Ministry of Tribal Affairs,2017,12,78,20,58,0.256410256,,,
Ministry of Tribal Affairs,2018,1,60,33,27,0.55,,,
Ministry of Tribal Affairs,2018,2,49,10,39,0.204081633,,,
Ministry of Tribal Affairs,2018,3,62,17,45,0.274193548,,,
Ministry of Tribal Affairs,2018,4,64,28,36,0.4375,,,
Ministry of Tribal Affairs,2018,5,113,118,-5,1.044247788,,,
Ministry of Tribal Affairs,2018,6,30,76,-46,2.533333333,,,
Ministry of Tribal Affairs,2018,7,51,54,-3,1.058823529,,,
Ministry of Tribal Affairs,2018,8,65,54,11,0.830769231,,,
Ministry of Tribal Affairs,2018,9,73,13,60,0.178082192,,,
Ministry of Tribal Affairs,2018,10,55,503,-448,9.145454545,,,
Ministry of Tribal Affairs,2018,11,54,70,-16,1.296296296,,,
Ministry of Tribal Affairs,2018,12,148,86,62,0.581081081,,,
Ministry of Tribal Affairs,2019,1,144,99,45,0.6875,,,
Ministry of Tribal Affairs,2019,2,130,194,-64,1.492307692,,,
Ministry of Tribal Affairs,2019,3,116,112,4,0.965517241,,,
Ministry of Tribal Affairs,2019,4,70,90,-20,1.285714286,,,
Ministry of Tribal Affairs,2019,5,60,43,17,0.716666667,,,
Ministry of Tribal Affairs,2019,6,123,94,29,0.764227642,,,
Ministry of Tribal Affairs,2019,7,138,72,66,0.52173913,,,
Ministry of Tribal Affairs,2019,8,98,233,-135,2.37755102,,,
Ministry of Tribal Affairs,2019,9,140,56,84,0.4,,,
Ministry of Tribal Affairs,2019,10,73,56,17,0.767123288,,,
Ministry of Tribal Affairs,2019,11,4,1,3,0.25,,,
"Ministry of Water Resources, River Development & Ganga Rejuv",2016,1,178,31,147,0.174157303,,,
"Ministry of Water Resources, River Development & Ganga Rejuv",2016,2,211,45,166,0.213270142,,,
"Ministry of Water Resources, River Development & Ganga Rejuv",2016,3,281,107,174,0.380782918,,,
"Ministry of Water Resources, River Development & Ganga Rejuv",2016,4,572,211,361,0.368881119,,,
"Ministry of Water Resources, River Development & Ganga Rejuv",2016,5,391,250,141,0.639386189,,,
"Ministry of Water Resources, River Development & Ganga Rejuv",2016,6,372,193,179,0.518817204,,,
"Ministry of Water Resources, River Development & Ganga Rejuv",2016,7,267,225,42,0.842696629,,,
"Ministry of Water Resources, River Development & Ganga Rejuv",2016,8,434,302,132,0.695852535,,,
"Ministry of Water Resources, River Development & Ganga Rejuv",2016,9,1202,570,632,0.474209651,,,
"Ministry of Water Resources, River Development & Ganga Rejuv",2016,10,350,423,-73,1.208571429,,,
"Ministry of Water Resources, River Development & Ganga Rejuv",2016,11,199,455,-256,2.286432161,,,
"Ministry of Water Resources, River Development & Ganga Rejuv",2016,12,238,1023,-785,4.298319328,,,
"Ministry of Water Resources, River Development & Ganga Rejuv",2017,1,213,66,147,0.309859155,,,
"Ministry of Water Resources, River Development & Ganga Rejuv",2017,2,203,359,-156,1.768472906,,,
"Ministry of Water Resources, River Development & Ganga Rejuv",2017,3,346,534,-188,1.543352601,,,
"Ministry of Water Resources, River Development & Ganga Rejuv",2017,4,250,232,18,0.928,,,
"Ministry of Water Resources, River Development & Ganga Rejuv",2017,5,291,332,-41,1.140893471,,,
"Ministry of Water Resources, River Development & Ganga Rejuv",2017,6,255,90,165,0.352941176,,,
"Ministry of Water Resources, River Development & Ganga Rejuv",2017,7,353,423,-70,1.198300283,,,
"Ministry of Water Resources, River Development & Ganga Rejuv",2017,8,439,570,-131,1.298405467,,,
"Ministry of Water Resources, River Development & Ganga Rejuv",2017,9,367,288,79,0.784741144,,,
"Ministry of Water Resources, River Development & Ganga Rejuv",2017,10,217,545,-328,2.511520737,,,
"Ministry of Water Resources, River Development & Ganga Rejuv",2017,11,341,411,-70,1.205278592,,,
"Ministry of Water Resources, River Development & Ganga Rejuv",2017,12,273,124,149,0.454212454,,,
"Ministry of Water Resources, River Development & Ganga Rejuv",2018,1,220,471,-251,2.140909091,,,
"Ministry of Water Resources, River Development & Ganga Rejuv",2018,2,197,186,11,0.944162437,,,
"Ministry of Water Resources, River Development & Ganga Rejuv",2018,3,201,212,-11,1.054726368,,,
"Ministry of Water Resources, River Development & Ganga Rejuv",2018,4,328,201,127,0.612804878,,,
"Ministry of Water Resources, River Development & Ganga Rejuv",2018,5,394,383,11,0.972081218,,,
"Ministry of Water Resources, River Development & Ganga Rejuv",2018,6,330,308,22,0.933333333,,,
"Ministry of Water Resources, River Development & Ganga Rejuv",2018,7,368,237,131,0.644021739,,,
"Ministry of Water Resources, River Development & Ganga Rejuv",2018,8,447,572,-125,1.279642058,,,
"Ministry of Water Resources, River Development & Ganga Rejuv",2018,9,321,315,6,0.981308411,,,
"Ministry of Water Resources, River Development & Ganga Rejuv",2018,10,462,342,120,0.74025974,,,
"Ministry of Water Resources, River Development & Ganga Rejuv",2018,11,289,417,-128,1.442906574,,,
"Ministry of Water Resources, River Development & Ganga Rejuv",2018,12,293,233,60,0.795221843,,,
"Ministry of Water Resources, River Development & Ganga Rejuv",2019,1,276,330,-54,1.195652174,,,
"Ministry of Water Resources, River Development & Ganga Rejuv",2019,2,273,309,-36,1.131868132,,,
"Ministry of Water Resources, River Development & Ganga Rejuv",2019,3,190,233,-43,1.226315789,,,
"Ministry of Water Resources, River Development & Ganga Rejuv",2019,4,165,86,79,0.521212121,,,
"Ministry of Water Resources, River Development & Ganga Rejuv",2019,5,241,194,47,0.804979253,,,
"Ministry of Water Resources, River Development & Ganga Rejuv",2019,6,384,363,21,0.9453125,,,
"Ministry of Water Resources, River Development & Ganga Rejuv",2019,7,630,446,184,0.707936508,,,
"Ministry of Water Resources, River Development & Ganga Rejuv",2019,8,457,342,115,0.748358862,,,
"Ministry of Water Resources, River Development & Ganga Rejuv",2019,9,360,413,-53,1.147222222,,,
"Ministry of Water Resources, River Development & Ganga Rejuv",2019,10,294,188,106,0.639455782,,,
"Ministry of Water Resources, River Development & Ganga Rejuv",2019,11,9,1,8,0.111111111,,,
Ministry of Women and Child Development,2016,1,267,208,59,0.779026217,,,
Ministry of Women and Child Development,2016,2,338,274,64,0.810650888,,,
Ministry of Women and Child Development,2016,3,409,333,76,0.814180929,,,
Ministry of Women and Child Development,2016,4,313,302,11,0.96485623,,,
Ministry of Women and Child Development,2016,5,317,229,88,0.722397476,,,
Ministry of Women and Child Development,2016,6,406,359,47,0.884236453,,,
Ministry of Women and Child Development,2016,7,383,522,-139,1.362924282,,,
Ministry of Women and Child Development,2016,8,384,385,-1,1.002604167,,,
Ministry of Women and Child Development,2016,9,353,326,27,0.923512748,,,
Ministry of Women and Child Development,2016,10,279,245,34,0.878136201,,,
Ministry of Women and Child Development,2016,11,286,160,126,0.559440559,,,
Ministry of Women and Child Development,2016,12,407,157,250,0.385749386,,,
Ministry of Women and Child Development,2017,1,467,538,-71,1.152034261,,,
Ministry of Women and Child Development,2017,2,372,450,-78,1.209677419,,,
Ministry of Women and Child Development,2017,3,439,168,271,0.382687927,,,
Ministry of Women and Child Development,2017,4,392,737,-345,1.880102041,,,
Ministry of Women and Child Development,2017,5,361,533,-172,1.476454294,,,
Ministry of Women and Child Development,2017,6,317,249,68,0.785488959,,,
Ministry of Women and Child Development,2017,7,490,578,-88,1.179591837,,,
Ministry of Women and Child Development,2017,8,287,253,34,0.881533101,,,
Ministry of Women and Child Development,2017,9,313,237,76,0.757188498,,,
Ministry of Women and Child Development,2017,10,240,120,120,0.5,,,
Ministry of Women and Child Development,2017,11,328,410,-82,1.25,,,
Ministry of Women and Child Development,2017,12,282,275,7,0.975177305,,,
Ministry of Women and Child Development,2018,1,221,173,48,0.78280543,,,
Ministry of Women and Child Development,2018,2,207,371,-164,1.792270531,,,
Ministry of Women and Child Development,2018,3,257,283,-26,1.101167315,,,
Ministry of Women and Child Development,2018,4,330,195,135,0.590909091,,,
Ministry of Women and Child Development,2018,5,421,481,-60,1.142517815,,,
Ministry of Women and Child Development,2018,6,253,337,-84,1.33201581,,,
Ministry of Women and Child Development,2018,7,422,349,73,0.827014218,,,
Ministry of Women and Child Development,2018,8,360,197,163,0.547222222,,,
Ministry of Women and Child Development,2018,9,357,675,-318,1.890756303,,,
Ministry of Women and Child Development,2018,10,348,352,-4,1.011494253,,,
Ministry of Women and Child Development,2018,11,318,339,-21,1.066037736,,,
Ministry of Women and Child Development,2018,12,298,303,-5,1.016778523,,,
Ministry of Women and Child Development,2019,1,370,346,24,0.935135135,,,
Ministry of Women and Child Development,2019,2,283,352,-69,1.243816254,,,
Ministry of Women and Child Development,2019,3,314,303,11,0.964968153,,,
Ministry of Women and Child Development,2019,4,212,198,14,0.933962264,,,
Ministry of Women and Child Development,2019,5,266,247,19,0.928571429,,,
Ministry of Women and Child Development,2019,6,455,448,7,0.984615385,,,
Ministry of Women and Child Development,2019,7,581,529,52,0.910499139,,,
Ministry of Women and Child Development,2019,8,550,561,-11,1.02,,,
Ministry of Women and Child Development,2019,9,641,616,25,0.96099844,,,
Ministry of Women and Child Development,2019,10,511,533,-22,1.043052838,,,
Ministry of Women and Child Development,2019,11,14,21,-7,1.5,,,
National Commission for Scheduled Caste,2018,9,1,1,0,1,,,
National Human Rights Commission,2016,12,3,27,-24,9,,,
National Human Rights Commission,2017,1,2,2,0,1,,,
NITI Aayog,2016,1,47,1,46,0.021276596,,,
NITI Aayog,2016,2,83,2,81,0.024096386,,,
NITI Aayog,2016,5,73,13,60,0.178082192,,,
NITI Aayog,2016,6,75,35,40,0.466666667,,,
NITI Aayog,2016,7,78,13,65,0.166666667,,,
NITI Aayog,2016,9,124,8,116,0.064516129,,,
NITI Aayog,2016,12,174,1,173,0.005747126,,,
NITI Aayog,2017,1,196,8,188,0.040816327,,,
NITI Aayog,2017,2,157,10,147,0.063694268,,,
NITI Aayog,2017,3,219,12,207,0.054794521,,,
NITI Aayog,2017,4,191,2,189,0.010471204,,,
NITI Aayog,2017,5,209,9,200,0.043062201,,,
NITI Aayog,2017,6,218,37,181,0.169724771,,,
NITI Aayog,2017,7,267,168,99,0.629213483,,,
NITI Aayog,2017,8,145,33,112,0.227586207,,,
NITI Aayog,2017,9,110,173,-63,1.572727273,,,
NITI Aayog,2017,10,131,101,30,0.770992366,,,
NITI Aayog,2017,11,109,260,-151,2.385321101,,,
NITI Aayog,2017,12,98,245,-147,2.5,,,
NITI Aayog,2018,1,76,2246,-2170,29.55263158,,,
NITI Aayog,2018,2,64,93,-29,1.453125,,,
NITI Aayog,2018,3,97,87,10,0.896907216,,,
NITI Aayog,2018,4,127,106,21,0.834645669,,,
NITI Aayog,2018,5,124,146,-22,1.177419355,,,
NITI Aayog,2018,6,55,54,1,0.981818182,,,
NITI Aayog,2018,7,64,57,7,0.890625,,,
NITI Aayog,2018,8,123,116,7,0.943089431,,,
NITI Aayog,2018,9,66,80,-14,1.212121212,,,
NITI Aayog,2018,10,87,97,-10,1.114942529,,,
NITI Aayog,2018,11,91,81,10,0.89010989,,,
NITI Aayog,2018,12,145,155,-10,1.068965517,,,
NITI Aayog,2019,1,103,108,-5,1.048543689,,,
NITI Aayog,2019,2,99,112,-13,1.131313131,,,
NITI Aayog,2019,3,91,79,12,0.868131868,,,
NITI Aayog,2019,4,57,51,6,0.894736842,,,
NITI Aayog,2019,5,42,47,-5,1.119047619,,,
NITI Aayog,2019,6,151,118,33,0.781456954,,,
NITI Aayog,2019,7,142,129,13,0.908450704,,,
NITI Aayog,2019,8,141,132,9,0.936170213,,,
NITI Aayog,2019,9,194,240,-46,1.237113402,,,
NITI Aayog,2019,10,137,153,-16,1.116788321,,,
O/o the Comptroller & Auditor General of India,2016,1,49,16,33,0.326530612,,,
O/o the Comptroller & Auditor General of India,2016,2,69,36,33,0.52173913,,,
O/o the Comptroller & Auditor General of India,2016,3,79,63,16,0.797468354,,,
O/o the Comptroller & Auditor General of India,2016,4,78,67,11,0.858974359,,,
O/o the Comptroller & Auditor General of India,2016,5,77,82,-5,1.064935065,,,
O/o the Comptroller & Auditor General of India,2016,6,89,80,9,0.898876404,,,
O/o the Comptroller & Auditor General of India,2016,7,73,55,18,0.753424658,,,
O/o the Comptroller & Auditor General of India,2016,8,98,102,-4,1.040816327,,,
O/o the Comptroller & Auditor General of India,2016,9,97,115,-18,1.18556701,,,
O/o the Comptroller & Auditor General of India,2016,10,72,58,14,0.805555556,,,
O/o the Comptroller & Auditor General of India,2016,11,68,85,-17,1.25,,,
O/o the Comptroller & Auditor General of India,2016,12,80,75,5,0.9375,,,
O/o the Comptroller & Auditor General of India,2017,1,82,111,-29,1.353658537,,,
O/o the Comptroller & Auditor General of India,2017,2,82,81,1,0.987804878,,,
O/o the Comptroller & Auditor General of India,2017,3,66,89,-23,1.348484848,,,
O/o the Comptroller & Auditor General of India,2017,4,96,51,45,0.53125,,,
O/o the Comptroller & Auditor General of India,2017,5,128,97,31,0.7578125,,,
O/o the Comptroller & Auditor General of India,2017,6,105,92,13,0.876190476,,,
O/o the Comptroller & Auditor General of India,2017,7,116,92,24,0.793103448,,,
O/o the Comptroller & Auditor General of India,2017,8,90,81,9,0.9,,,
O/o the Comptroller & Auditor General of India,2017,9,150,169,-19,1.126666667,,,
O/o the Comptroller & Auditor General of India,2017,10,113,59,54,0.522123894,,,
O/o the Comptroller & Auditor General of India,2017,11,177,241,-64,1.361581921,,,
O/o the Comptroller & Auditor General of India,2017,12,158,146,12,0.924050633,,,
O/o the Comptroller & Auditor General of India,2018,1,448,156,292,0.348214286,,,
O/o the Comptroller & Auditor General of India,2018,2,153,451,-298,2.947712418,,,
O/o the Comptroller & Auditor General of India,2018,3,299,245,54,0.819397993,,,
O/o the Comptroller & Auditor General of India,2018,4,452,499,-47,1.103982301,,,
O/o the Comptroller & Auditor General of India,2018,5,293,282,11,0.962457338,,,
O/o the Comptroller & Auditor General of India,2018,6,140,135,5,0.964285714,,,
O/o the Comptroller & Auditor General of India,2018,7,188,247,-59,1.313829787,,,
O/o the Comptroller & Auditor General of India,2018,8,327,151,176,0.4617737,,,
O/o the Comptroller & Auditor General of India,2018,9,420,532,-112,1.266666667,,,
O/o the Comptroller & Auditor General of India,2018,10,417,421,-4,1.009592326,,,
O/o the Comptroller & Auditor General of India,2018,11,1150,1053,97,0.915652174,,,
O/o the Comptroller & Auditor General of India,2018,12,416,538,-122,1.293269231,,,
O/o the Comptroller & Auditor General of India,2019,1,695,706,-11,1.015827338,,,
O/o the Comptroller & Auditor General of India,2019,2,860,825,35,0.959302326,,,
O/o the Comptroller & Auditor General of India,2019,3,345,358,-13,1.037681159,,,
O/o the Comptroller & Auditor General of India,2019,4,323,364,-41,1.126934985,,,
O/o the Comptroller & Auditor General of India,2019,5,325,312,13,0.96,,,
O/o the Comptroller & Auditor General of India,2019,6,263,262,1,0.996197719,,,
O/o the Comptroller & Auditor General of India,2019,7,692,674,18,0.973988439,,,
O/o the Comptroller & Auditor General of India,2019,8,629,624,5,0.992050874,,,
O/o the Comptroller & Auditor General of India,2019,9,580,526,54,0.906896552,,,
O/o the Comptroller & Auditor General of India,2019,10,758,747,11,0.985488127,,,
O/o the Comptroller & Auditor General of India,2019,11,3,4,-1,1.333333333,,,
Securities and Exchange Board of India,2016,1,105,27,78,0.257142857,,,
Securities and Exchange Board of India,2016,2,172,49,123,0.284883721,,,
Securities and Exchange Board of India,2016,3,156,96,60,0.615384615,,,
Securities and Exchange Board of India,2016,4,298,155,143,0.520134228,,,
Securities and Exchange Board of India,2016,5,210,352,-142,1.676190476,,,
Securities and Exchange Board of India,2016,6,240,293,-53,1.220833333,,,
Securities and Exchange Board of India,2016,7,245,211,34,0.86122449,,,
Securities and Exchange Board of India,2016,8,284,254,30,0.894366197,,,
Securities and Exchange Board of India,2016,9,215,280,-65,1.302325581,,,
Securities and Exchange Board of India,2016,10,874,167,707,0.191075515,,,
Securities and Exchange Board of India,2016,11,1508,1802,-294,1.194960212,,,
Securities and Exchange Board of India,2016,12,739,814,-75,1.101488498,,,
Securities and Exchange Board of India,2017,1,846,1029,-183,1.216312057,,,
Securities and Exchange Board of India,2017,2,860,1033,-173,1.201162791,,,
Securities and Exchange Board of India,2017,3,832,768,64,0.923076923,,,
Securities and Exchange Board of India,2017,4,629,685,-56,1.089030207,,,
Securities and Exchange Board of India,2017,5,660,692,-32,1.048484848,,,
Securities and Exchange Board of India,2017,6,533,435,98,0.816135084,,,
Securities and Exchange Board of India,2017,7,560,132,428,0.235714286,,,
Securities and Exchange Board of India,2017,8,463,477,-14,1.030237581,,,
Securities and Exchange Board of India,2017,9,432,175,257,0.405092593,,,
Securities and Exchange Board of India,2017,10,435,161,274,0.370114943,,,
Securities and Exchange Board of India,2017,11,1593,1041,552,0.653483992,,,
Securities and Exchange Board of India,2017,12,253,1372,-1119,5.422924901,,,
Securities and Exchange Board of India,2018,1,275,413,-138,1.501818182,,,
Securities and Exchange Board of India,2018,2,221,558,-337,2.524886878,,,
Securities and Exchange Board of India,2018,3,296,253,43,0.85472973,,,
Securities and Exchange Board of India,2018,4,330,279,51,0.845454545,,,
Securities and Exchange Board of India,2018,5,464,498,-34,1.073275862,,,
Securities and Exchange Board of India,2018,6,430,373,57,0.86744186,,,
Securities and Exchange Board of India,2018,7,512,326,186,0.63671875,,,
Securities and Exchange Board of India,2018,8,361,637,-276,1.764542936,,,
Securities and Exchange Board of India,2018,9,388,399,-11,1.028350515,,,
Securities and Exchange Board of India,2018,10,376,339,37,0.901595745,,,
Securities and Exchange Board of India,2018,11,302,359,-57,1.188741722,,,
Securities and Exchange Board of India,2018,12,362,381,-19,1.052486188,,,
Securities and Exchange Board of India,2019,1,438,409,29,0.933789954,,,
Securities and Exchange Board of India,2019,2,436,427,9,0.979357798,,,
Securities and Exchange Board of India,2019,3,341,358,-17,1.049853372,,,
Securities and Exchange Board of India,2019,4,309,243,66,0.786407767,,,
Securities and Exchange Board of India,2019,5,413,448,-35,1.084745763,,,
Securities and Exchange Board of India,2019,6,631,638,-7,1.011093502,,,
Securities and Exchange Board of India,2019,7,700,733,-33,1.047142857,,,
Securities and Exchange Board of India,2019,8,579,492,87,0.849740933,,,
Securities and Exchange Board of India,2019,9,701,707,-6,1.008559201,,,
Securities and Exchange Board of India,2019,10,574,520,54,0.905923345,,,
Securities and Exchange Board of India,2019,11,34,43,-9,1.264705882,,,
Unique Identification Authority of India,2016,1,214,18,196,0.08411215,,,
Unique Identification Authority of India,2016,2,333,136,197,0.408408408,,,
Unique Identification Authority of India,2016,3,387,303,84,0.782945736,,,
Unique Identification Authority of India,2016,4,446,288,158,0.64573991,,,
Unique Identification Authority of India,2016,5,300,538,-238,1.793333333,,,
Unique Identification Authority of India,2016,6,441,350,91,0.793650794,,,
Unique Identification Authority of India,2016,7,471,458,13,0.972399151,,,
Unique Identification Authority of India,2016,8,488,594,-106,1.217213115,,,
Unique Identification Authority of India,2016,9,521,492,29,0.944337812,,,
Unique Identification Authority of India,2016,10,427,432,-5,1.011709602,,,
Unique Identification Authority of India,2016,11,502,480,22,0.956175299,,,
Unique Identification Authority of India,2016,12,901,427,474,0.473917869,,,
Unique Identification Authority of India,2017,1,911,960,-49,1.053787047,,,
Unique Identification Authority of India,2017,2,797,898,-101,1.12672522,,,
Unique Identification Authority of India,2017,3,945,1067,-122,1.129100529,,,
Unique Identification Authority of India,2017,4,965,796,169,0.824870466,,,
Unique Identification Authority of India,2017,5,975,919,56,0.942564103,,,
Unique Identification Authority of India,2017,6,1428,1007,421,0.705182073,,,
Unique Identification Authority of India,2017,7,2128,1645,483,0.773026316,,,
Unique Identification Authority of India,2017,8,1996,2136,-140,1.070140281,,,
Unique Identification Authority of India,2017,9,1341,1620,-279,1.208053691,,,
Unique Identification Authority of India,2017,10,1230,1365,-135,1.109756098,,,
Unique Identification Authority of India,2017,11,1677,1438,239,0.857483602,,,
Unique Identification Authority of India,2017,12,1707,1485,222,0.869947276,,,
Unique Identification Authority of India,2018,1,1358,1381,-23,1.016936672,,,
Unique Identification Authority of India,2018,2,1065,1034,31,0.970892019,,,
Unique Identification Authority of India,2018,3,1310,1555,-245,1.187022901,,,
Unique Identification Authority of India,2018,4,918,1093,-175,1.190631808,,,
Unique Identification Authority of India,2018,5,916,1558,-642,1.700873362,,,
Unique Identification Authority of India,2018,6,613,664,-51,1.08319739,,,
Unique Identification Authority of India,2018,7,833,839,-6,1.007202881,,,
Unique Identification Authority of India,2018,8,784,881,-97,1.12372449,,,
Unique Identification Authority of India,2018,9,620,615,5,0.991935484,,,
Unique Identification Authority of India,2018,10,565,736,-171,1.302654867,,,
Unique Identification Authority of India,2018,11,430,456,-26,1.060465116,,,
Unique Identification Authority of India,2018,12,597,609,-12,1.020100503,,,
Unique Identification Authority of India,2019,1,721,595,126,0.825242718,,,
Unique Identification Authority of India,2019,2,674,631,43,0.93620178,,,
Unique Identification Authority of India,2019,3,716,635,81,0.886871508,,,
Unique Identification Authority of India,2019,4,570,637,-67,1.11754386,,,
Unique Identification Authority of India,2019,5,549,680,-131,1.238615665,,,
Unique Identification Authority of India,2019,6,780,522,258,0.669230769,,,
Unique Identification Authority of India,2019,7,1050,907,143,0.863809524,,,
Unique Identification Authority of India,2019,8,856,800,56,0.934579439,,,
Unique Identification Authority of India,2019,9,892,992,-100,1.112107623,,,
Unique Identification Authority of India,2019,10,751,890,-139,1.185086551,,,
Unique Identification Authority of India,2019,11,26,32,-6,1.230769231,,,
